You wake up to shouts and loud banging. It is early; the sun has just begun to rise. After groggily getting out from bed, you peer out the window. There is a crowd of people gathered outside, in front of the Mayor's House.

Mercenaries
An Interactive Fiction by Elana Shi
Release 1 / Serial number 141030 / Inform 7 build 6L38 (I6/v6.33 lib 6/12N) SD

Cottage
A small one room compartment. Shoved into the corner of the room is your bed. Next to the door is your sorry excuse of a kitchen: a small stove, and a sink. At the center of the room is a squat wooden table. On the wall above your sink is a small one way window that looks into Town Square. You can go to Town Square by going East.

>take all
There are none at all available!

>e
Town Square
A square plaza with a cobblestone ground. Along the sides of the square are many two-story buildings. At the center of the square is a tall stone fountain, encircled by several wooden benches. Your cottage is to the West. East is the Mayor's House. There is a crowd gathered outside the Mayor's House.

>take all
There are none at all available!

>w
Cottage
A small one room compartment. Shoved into the corner of the room is your bed. Next to the door is your sorry excuse of a kitchen: a small stove, and a sink. At the center of the room is a squat wooden table with the stone on it. On the wall above your sink is a small one way window that looks into Town Square. You can go to Town Square by going East.

>take everything
There are none at all available!

>x bed
Your sheets are tangled into a ball at the foot of the mattress. In contrast, your pillow sits neatly at the front of the bed. The twin sized bed, meant for children, is made of a light brown wood. You brought it to your cottage after moving out of your parent's house, for there was no reason to throw it away.

>take bed
That's hardly portable.

>l
Cottage
A small one room compartment. Shoved into the corner of the room is your bed. Next to the door is your sorry excuse of a kitchen: a small stove, and a sink. At the center of the room is a squat wooden table with the stone on it. On the wall above your sink is a small one way window that looks into Town Square. You can go to Town Square by going East.

>e
Town Square
A square plaza with a cobblestone ground. Along the sides of the square are many two-story buildings. At the center of the square is a tall stone fountain, encircled by several wooden benches. Your cottage is to the West. East is the Mayor's House. There is a crowd gathered outside the Mayor's House.

>e
You pull the on the brass handle, but the door appears to unlocked. Plus, it's not your home-you shouldn't go in without permission.

>n
You can't go that way.

>w
Cottage
A small one room compartment. Shoved into the corner of the room is your bed. Next to the door is your sorry excuse of a kitchen: a small stove, and a sink. At the center of the room is a squat wooden table with the stone on it. On the wall above your sink is a small one way window that looks into Town Square. You can go to Town Square by going East.

>e
Town Square
A square plaza with a cobblestone ground. Along the sides of the square are many two-story buildings. At the center of the square is a tall stone fountain, encircled by several wooden benches. Your cottage is to the West. East is the Mayor's House. There is a crowd gathered outside the Mayor's House.

>s
You have no reason to go to the Station.

>e
You pull the on the brass handle, but the door appears to unlocked. Plus, it's not your home-you shouldn't go in without permission.

>w
Cottage
A small one room compartment. Shoved into the corner of the room is your bed. Next to the door is your sorry excuse of a kitchen: a small stove, and a sink. At the center of the room is a squat wooden table with the stone on it. On the wall above your sink is a small one way window that looks into Town Square. You can go to Town Square by going East.

>n
You can't go that way.

>s
You can't go that way.

>w
You can't go that way.

>e
Town Square
A square plaza with a cobblestone ground. Along the sides of the square are many two-story buildings. At the center of the square is a tall stone fountain, encircled by several wooden benches. Your cottage is to the West. East is the Mayor's House. There is a crowd gathered outside the Mayor's House.

>x bench
Plain wooden benches meant for decoration. Years ago when you were a small child, you would stand on these benches and haughtily beamed over your friend's heads. You were the king of the world!

>x crowd
The crowd consists of angry village women and men. They hold pitchforks and shovel; you cannot see what's happening as they are too tall.

>talk to crowd
You can only do that to something animate.

>l
Town Square
A square plaza with a cobblestone ground. Along the sides of the square are many two-story buildings. At the center of the square is a tall stone fountain, encircled by several wooden benches. Your cottage is to the West. East is the Mayor's House. There is a crowd gathered outside the Mayor's House.

>x ground
Medium sized rocks lay in a circular pattern around the fountain.

>x buildings
Two-story buildings line the side of the square. These buildings contain homes, stores, and restaurants. The stores and restaurants are all closed, but dim lights illuminate from the windows.

>x windows
You can't see any such thing.

>get on bench
You get onto Benches.

After stepping onto the bench, you take a look over the crowd. What you see does not surprise you. A young man in a black suit stands proudly at the center of the crowd, a smirk corrupting his handsome face. This man is Edgar, a representative of the Company. Next to him, the Mayor angrily faces him. He looks like he wants to punch Edgar right then and there, but is holding back for some reason.

>e
(first getting off Benches)

Mayor's House
When you walk into the house, you are stunned by the beautiful furnishing that seems to glitter in the house. At the center of the pearly marble white floor is a large glossy wooden dining table, on top of which is an elegant flower arrangement. Under a magnificent acrylic painting is a polished large leather sofa. The Mayor plops down on the sofa and deflates.

>talk to mayer
You can't see any such thing.

>talk to mayor
You can't see any such thing.

>w
You can't go that way.

>talk ot man
I didn't understand that sentence.

>talk to man
You can't see any such thing.

>get on bench
You can't see any such thing.

>e
You can't go that way.

* * *

>take all
There are none at all available!

>x stone
The townspeople call it Cloud Stone. The opaque material is an intense purple, mixed with greys and whites. The colors swirls into intricate patterns that almost look artificially enhanced. Just two years ago, there were only a couple of stones that a select few families held. But then the Company discovered the precious materials, and began digging deep into the villager's farms. There, they found masses of the Cloud Stone, which they called Charoite. Shortly after, they offered a huge sum of money to the town's mayor, hoping that he would allow the Company to keep digging. The mayor refused.

>take stone
Taken.

>x beed
You can't see any such thing.

>x bed
Your sheets are tangled into a ball at the foot of the mattress. In contrast, your pillow sits neatly at the front of the bed. The twin sized bed, meant for children, is made of a light brown wood. You brought it to your cottage after moving out of your parent's house, for there was no reason to throw it away.

>take pillow
That's hardly portable.

>x kitchen
Super simplistic. Consists of only a sink and a stove.

>x sink
A year ago, the mayor cut off all water from the pipes to prevent the Company's factory from working. Although it was inconvenient, the town's residents all agreed that we needed to send a warning to the Company.

>x stove
Occasionally you dabble in some cooking, and you're quite good at it too. The neighbors often ask for recipes and tips, which you willingly give. The stove itself is quite old, as you bought it from a second hand store.

>take sink
That's hardly portable.

>tanke stove
That's not a verb I recognise.

>look
Cottage
A small one room compartment. Shoved into the corner of the room is your bed. Next to the door is your sorry excuse of a kitchen: a small stove, and a sink. At the center of the room is a squat wooden table. On the wall above your sink is a small one way window that looks into Town Square. You can go to Town Square by going East.

>x table
A round wooden table that you constructed out of the spare wood pile from the carpenter. It serves as your desk and dining table. At the center of the table is a polished purple stone.

>look out window
I only understood you as far as wanting to look outside.

>look outside
You see nothing unexpected in that direction.

>x window
The window overlooks Town Hall. There is a crowd of people gathered outside.

>e
Town Square
A square plaza with a cobblestone ground. Along the sides of the square are many two-story buildings. At the center of the square is a tall stone fountain, encircled by several wooden benches. Your cottage is to the West. East is the Mayor's House. There is a crowd gathered outside the Mayor's House.

>x crowd
The crowd consists of angry village women and men. They hold pitchforks and shovel; you cannot see what's happening as they are too tall.

>take crowd
That's hardly portable.

>x buildings
Two-story buildings line the side of the square. These buildings contain homes, stores, and restaurants. The stores and restaurants are all closed, but dim lights illuminate the windows.

>x windows
You can't see any such thing.

>x lights
You can't see any such thing.

>x stores
You can't see any such thing.

>x restaurants
You can't see any such thing.

* * *

>take everything
There are none at all available!

>e
Wait. You still have to take your Cloud Stone, it should be on the table.

>take cloud stone
Taken.

>e
Town Square
A square plaza with a cobblestone ground. Along the sides of the square are many two-story buildings. At the center of the square is a tall stone fountain, encircled by several wooden benches. Your cottage is to the West. East is the Mayor's House. There is a crowd gathered outside the Mayor's House.

>talk to mayor
You push and squeeze through the crowd of angry villagers until you come to the Mayor. He does not even notice you until you shake him roughly on the shoulder. You have to shout for him to hear you, "Sir, what is happening?"

"Him," he points to Edgar. "He just informed us that the Company has Felix."

You are taken aback. They have Felix?

"Your son, Felix?"

"Who else?!" The mayor cries angrily. "They want the damn rocks! Now they've resorted to this trickery and blackmailing. What villains!"

"What can we do?" You ask earnestly.

"I don't know," he says as he shakes his head, "Why don't we go into the house to speak."

"Alright." The mayor turns to Edgar and says in his booming voice,

"Enough!" The crowd goes silent. "Edgar. We will give you an answer soon. In the meantime, at least tell me where my son is."

Edgar laughs. "Now? Probably on the way to the City. I will await your reply," he cackles as he walks away. The mob of villagers glare at Edgar, as he arrogantly strides away. When he is out of sight, the villagers begin to head back to their homes, grumbling to themselves.

You turn to the Mayor and he unlocks the door to his house. You follow him into the spacious mansion.

Mayor's House
When you walk into the house, you are stunned by the beautiful furnishing that seems to glitter in the house. At the center of the pearly marble white floor is a large glossy wooden table. Under a magnificent acrylic painting is a polished large leather sofa. The Mayor plops down on the sofa and deflates.

>talk to mayor
"Mayor, I think we need to hurry." The Mayor closes his eyes.

"Yes," he murmurs, "We should. Alex, I need you to chase my son. I am well past my prime, and cannot leave the villagers. Heaven only knows what they would do if I walked away from the town. Please go to the Station and save my son." You nod dutifully, and walk to the exit.

Station
The Station is slow and idle. The town is not an attraction, and the Station is merely a stop for business men who need work in the city, or visit home. You see only a few business men walking around, luggages in tow. Prominently in the center of the station is a large faded red ticket booth. Next to it is a small kiosk, selling beverages and food items. To the south is the Train, waiting to depart.  Leaning against one of the pillars is a tall lanky boy, who you recognize instantly: Felix. Next to him is a man in a black suit, who Felix merrily jokes with. What in the world?

You can see Black Suit and Felix here.

>talk to rita
You walk up to the counter, and say,

"Hi Ms. Rita. Long time no see, how have you been?" Her eyes focus, and she smiles grimly.

"Hello Austin,"

"Alex", you correct.

"Alex. You know, same old same old. How's ya mother? She good?" You nod.

"Yep. Uh, listen Rita. I need a ticket onto that train over there. How much does it cost?"

"Sorry, boy. Tickets are all sold out. Budget cuts, ya know? They're limiting passengers to lighten the load." You raise your brow. Budget cuts?

"This is really important. The Company's done something real bad this time."

"The Company?" Rita's eyes bulge, "Oh dear. Uh... Oh! You see the Conductor over there? Sometimes he allows some extra people onto the train in exchange for something in return. Ya know what I mean?"

"How much?"

"$20 dollahs."

"20!? That's daylight robbery!" Ignoring you, she grabs a piece of scrap paper from her cluttered desk and scrawls something on it.

"Here," Rita says as she hands it to you. "Give it to the kiosk guy. He owes me."

>give paper to guy
You firmly place the paper scrap onto the kiosk desk. The man looks up from his book, and takes it. He unfolds the paper, and the corner of his mouth tugs upward. He turns to the cash register, and takes out a wad of cash, carefully counting it before he hands it to you. He does not say a word, and returns to his book.

>give cash to conductor
(Conductor)
You hand the Conductor the wad of cash. He flips through, quickly counting it, and nods.

"Alright. You're good to go!" You cringe on the inside. This corruption is not unfamiliar to you, but to engage in it yourself... it's so wrong. "ALL ABOARD!" He yells, and steps inside the Train.

>w
You can't go that way.

>s
the Sliding Door slides shut just as you leap into the Train Entrance car. You hear the train whir to life. Suddenly, you feel yourself stumble backwards, and find that outside, the scenery begins flying past. You hear the Conductor's voice again: "Hello everybody. We are now headed to the City. Relax, and enjoy your time during this journey."

Train Entrance
A rather small room with little furnishing. The walls are made mostly of polished wood, and the floor is covered with a dark purple carpet. The Passenger Car is Eastward. 

You can see Sir Allan here.

>e
Passenger Car
There are about 30 open seats uniformly lined up across the room, but only a few are occupied. This should be where everybody sits during the majority of the journey. To the East is the Observation Car, and North is the Toilet.

You can see Mark and Audrey here.

>e
Observation Car
A long with glass window on the walls and ceiling. There are several couches facing the windows, so that people can watch the beautiful scenery fly by. 

You can see Luna here.

>climb up ladder
 Luna eyes you suspiciously, as You grip the cold metal handle and pull yourself up.

Roof
At the top of the train, you feel very unsafe. However, as you gaze at your surroundings, you are struck with admiration of the beautiful landscape. In front of you, there is a long stretch of white panels that is the roof. You notice that there is a metal rod running across the edges of each car.  Caught under the metal rod is a black card.

I beg your pardon?

>e
You can't go that way.

I beg your pardon?

>undo
Roof
[Previous turn undone.]

>undo
Observation Car
[Previous turn undone.]

>talk to luna
You politely wave at Luna, and she waves back.

"Alex! What are you doing here?" she exclaims. You tell her about the Mayor's order,

"The Mayor told me to come and find Alex. But I can't seem to find him at all. What about you? Where are you headed to?"

"I was there this morning, and I've decided to travel to the city for legal help. If we can't push back the Company, then maybe the law can.

.

>w
Passenger Car
There are about 30 open seats uniformly lined up across the room, but only a few are occupied. This should be where everybody sits during the majority of the journey. To the East is the Observation Car, and North is the Toilet.

You can see Mark and Audrey here.

>e
Observation Car
A long with glass window on the walls and ceiling. There are several couches facing the windows, so that people can watch the beautiful scenery fly by. 

You can see Luna here.

>n
You can't go that way.

>w
Passenger Car
There are about 30 open seats uniformly lined up across the room, but only a few are occupied. This should be where everybody sits during the majority of the journey. To the East is the Observation Car, and North is the Toilet.

You can see Mark and Audrey here.

>n
The door is locked shut. You politely knock once. After a long minute of silence, you knock again. This time, you yell, "Is anybody there?!" Silence. You push the door with a bit of force.

"What in the world?" You slam your body against the door. You hear a slight crack.

You push again, and the lock breaks with a resounding clap. The door swings open and reveals the bathroom.

I beg your pardon?

>e
Observation Car
A long with glass window on the walls and ceiling. There are several couches facing the windows, so that people can watch the beautiful scenery fly by. On one of the couches is Luna's purse, which is placed on top of a Novel.

You can see Luna here.

>talk to luna
You can ask Luna about:

Herself.

The purpose of her journey.

What she was doing and where when the crime happened.

The victim.

Anything suspicious. 

.

>ask luna about anything suspicious
Luna thinks for a second, then says

"Yes. I saw that guy, Mark, rummaging through Felix's," her voice cracks, "-I mean the victim's things. You know what? Sorry. I want to be alone for a bit." Luna stands up and walks to the Passenger Car, leaving her purse behind.

>e
You can't go that way.

>climb up ladder
 You grip the cold metal handle and pull yourself up.

Roof
At the top of the train, you feel very unsafe. However, as you gaze at your surroundings, you are struck with admiration of the beautiful landscape. In front of you, there is a long stretch of white panels that is the roof. You notice that there is a metal rod running across the edges of each car.

I beg your pardon?

>take card
As you pick up the card, you hear a small sound behind you. There is a clink, and then everything goes black.

    *** You feel your body get thrown off the train, and then nothing. ***

Would you like to RESTART, RESTORE a saved game, QUIT or UNDO the last command?

* * *

>x table
A round wooden table that you constructed out of the spare wood pile from the carpenter. It serves as your desk and dining table. At the center of the table is a polished purple stone.

>take stone
Taken.

>x table
A round wooden table that you constructed out of the spare wood pile from the carpenter. It serves as your desk and dining table.

* * *

>x table
A round wooden table that you constructed out of the spare wood pile from the carpenter. It serves as your desk and dining table. At the center of the table is a polished purple stone.

>x stone
The townspeople call it Cloud Stone. The opaque material is an intense purple, mixed with greys and whites. The colors swirls into intricate patterns that almost look artificially enhanced. Just two years ago, there were only a couple of stones that a select few families held. But then the Company discovered the precious materials, and began digging deep into the villager's farms. There, they found masses of the Cloud Stone, which they called Charoite. Shortly after, they offered a huge sum of money to the town's Mayor, hoping that he would allow the Company to keep digging. The Mayor refused.

>take stone
Taken.

>x window
The window overlooks Town Hall. There is a crowd of people gathered outside.

>x stx stove
You can't see any such thing.

>x stove
Occasionally you dabble in some cooking, and you're quite good at it too. The neighbors often ask for recipes and tips, which you willingly give. The stove itself is quite old, as you bought it from a second hand store.

>x sink
A year ago, the mayor cut off all water from the pipes to prevent the Company's factory from working. Although it was inconvenient, the town's residents all agreed that we needed to send a warning to the Company.

>e
Town Square
A square plaza with a cobblestone ground. Along the sides of the square are many two-story buildings. At the center of the square is a tall stone fountain, encircled by several wooden benches. Your cottage is to the West. East is the Mayor's House. There is a crowd gathered outside the Mayor's House.

>x fountain
The sculpture makes as a humble fountain, but radiates an aura of tranquility. The smooth stone features a woman carrying a flower in one hand and a rock in the other.

>x buildings
Two-story buildings line the side of the square. These buildings contain homes, stores, and restaurants. The stores and restaurants are all closed, but dim lights illuminate the windows.

>e
You pull the on the brass handle, but the door appears to unlocked. Plus, it's not your home-you shouldn't go in without permission.

>x crowd
The crowd consists of angry village women and men. They hold pitchforks and shovel; you cannot see what's happening as they are too tall.

>talk to corwd
You can't see any such thing.

>talk to crowd
You can only do that to something animate.

>talk to women
You can't see any such thing.

>i
You are carrying:
  Purple Stone

>x self
Your ear-length hair messily tangles around your face, you didn't have time to comb it this morning. In a rush, you threw on a pair of sneakers, a clean t-shirt, and shorts. You grew up in the village, and are very protective of it. You became the town sheriff, and are determined to undo the injustice done to the villagers.

>l
Town Square
A square plaza with a cobblestone ground. Along the sides of the square are many two-story buildings. At the center of the square is a tall stone fountain, encircled by several wooden benches. Your cottage is to the West. East is the Mayor's House. There is a crowd gathered outside the Mayor's House.

>x benches
Plain wooden benches meant for decoration. Years ago when you were a small child, you would stand on these benches and haughtily beam over your friend's heads. You were the king of the world!

>stand on benches
You get onto Benches.

After stepping onto the bench, you take a look over the crowd. What you see does not surprise you. A young man in a black suit stands proudly at the center of the crowd, a smirk corrupting his handsome face. This man is Edgar, a representative of the Company. Next to him, the Mayor angrily faces him. He looks like he wants to punch Edgar right then and there, but is holding back for some reason.

>talk to edgar
You yell out at Edgar, but your voice is lost in the shouts of the other villagers.

>talk to mayor
You push and squeeze through the crowd of angry villagers until you come to the Mayor. He does not even notice you until you shake him roughly on the shoulder. You have to shout for him to hear you, "Sir, what is happening?"

"Him," he points to Edgar. "He just informed us that the Company has Felix."

You are taken aback. They have Felix?

"Your son, Felix?"

"Who else?!" The mayor cries angrily. "They want the damn rocks! Now they've resorted to this trickery and blackmailing. What villains!"

"What can we do?" You ask earnestly.

"I don't know," he says as he shakes his head, "Why don't we go into the house to speak."

"Alright." The mayor turns to Edgar and says in his booming voice,

"Enough!" The crowd goes silent. "Edgar. We will give you an answer soon. In the meantime, at least tell me where my son is."

Edgar laughs. "Now? Probably on the way to the City. I will await your reply," he cackles as he walks away. The mob of villagers glare at Edgar, as he arrogantly strides away. When he is out of sight, the villagers begin to head back to their homes, grumbling to themselves.

You turn to the Mayor and he unlocks the door to his house. You follow him into the spacious mansion.

Mayor's House
When you walk into the house, you are stunned by the beautiful furnishing that seems to glitter in the house. At the center of the pearly marble white floor is a large glossy wooden table. Under a magnificent acrylic painting is a polished large leather sofa. The Mayor plops down on the sofa and deflates.

>tlktalk t mayor  mayor
That's not a verb I recognise.

>x painting
The subject in the painting is the Mayor. The painting depicts the Mayor in his earlier governing days, when he was young and fit. The stark contrast between the painting and the Mayor today show just how much of a toll the job has taken on him.

>x sofa
A pale earth colored leather sofa. The Mayor sits heavily on the wrinkled material.

>sit on sofa
You get onto Leather Sofa.

>talk to mayor
"Mayor, I think we need to hurry." The Mayor closes his eyes.

"Yes," he murmurs, "We should. Alex, I need you to chase my son. I am well past my prime, and cannot leave the villagers. Heaven only knows what they would do if I walked away from the town. Please go to the Station and save my son." You nod dutifully, and walk to the exit.

Station
The Station is slow and idle. The town is not an attraction, and the Station is merely a stop for business men who need work in the city, or visit home. You see only a few business men walking around, luggages in tow. Prominently in the center of the station is a large faded red ticket booth. Next to it is a small kiosk, selling beverages and food items. To the south is the Train, waiting to depart.  Leaning against one of the pillars is a tall lanky boy, who you recognize instantly: Felix. Next to him is a man in a black suit, who Felix merrily jokes with. What in the world?

You can see Black Suit and Felix here.

>talk to felix
You stride towards Felix, and slap him across the face. He is dumbfounded for a moment before registering who you are. He gestures apologetically to the the man in the Black Suit, who then walks away.

"What are you doing?" You shout at him.

"I'm going to the city, Alex," he retorts. "I'm sick of that stupid village. I don't want to inherit the position of mayor when I have the potential to do so much more. Luckily, the Company realized this and offered to relocate me. They're bringing me to the city, it's going to be wonderful!"

"You don't understand. Right now the Company has told your father that they are holding you in their custody. They said that if the villagers don't yield all of the Cloud Stones, they'll harm you."

"Don't joke with me. That old fart's probably willing to say anything to get me back to the village. And once they do, they'll never let me leave again."

"Shut up! If the villagers do end up handing over the stones, they'll capture you and toss you back into the village. Please Felix, come to your senses."

"No! I can't stay there. Even if your story is true, the villagers would never hand over the stupid rocks. They have too much pride for that!" The speakers in the Station suddenly blare out:

"Train 342 to the City is departing in 10 minutes-please board now. Thank you." Felix looks at you, then shoves you out of the way to gather his belongings.

>l
Station
The Station is slow and idle. The town is not an attraction, and the Station is merely a stop for business men who need work in the city, or visit home. You see only a few business men walking around, luggages in tow. Prominently in the center of the station is a large faded red ticket booth. Next to it is a small kiosk, selling beverages and food items. To the south is the Train, waiting to depart.  Leaning against one of the pillars is a tall lanky boy, who you recognize instantly: Felix. Next to him is a man in a black suit, who Felix merrily jokes with. What in the world?

You can see Black Suit and Felix here.

>x ticket booth'
I only understood you as far as wanting to examine Red Ticket Booth.

>x ticket booth
A squat boxy room standing in the middle of the station. The ticket booth is old, its bright red color faded from years of neglect. On its faded walls are years of expired promotion posters, graffiti, and dried gum. Its windows are dirty and unclean, but a clean piece of paper is pasted on the glass-a train table. Behind the counter sits a bored woman. On closer inspection, you realize that the woman is a villager named Rita.

>talk to felix
He angrily packs his things, ignoring your pleas for dialogue.

>talk to felix
He angrily packs his things, ignoring your pleas for dialogue.

>s
You walk up to the Train Conductor, an elderly man with a sneer on his face. You say,

"Ah. Hello. I need to get on the train."

"Do you have a ticket?" He asks. You shake your head.

"Do you have anything else that can get you on the train?" He opens his palm towards you, facing upwards.

>i
You are carrying:
  Purple Stone

>talk to rita
You walk up to the counter, and say,

"Hi Ms. Rita. Long time no see, how have you been?" Her eyes focus, and she smiles grimly.

"Hello Austin,"

"Alex", you correct.

"Alex. You know, same old same old. How's ya mother? She good?" You nod.

"Yep. Uh, listen Rita. I need a ticket onto that train over there. How much does it cost?"

"Sorry, boy. Tickets are all sold out. Budget cuts, ya know? They're limiting passengers to lighten the load." You raise your brow. Budget cuts?

"This is really important. The Company's done something real bad this time."

"The Company?" Rita's eyes bulge, "Oh dear. Uh... Oh! You see the Conductor over there? Sometimes he allows some extra people onto the train in exchange for something in return. Ya know what I mean?"

"How much?"

"$20 dollahs."

"20!? That's daylight robbery!" Ignoring you, she grabs a piece of scrap paper from her cluttered desk and scrawls something on it.

"Here," Rita says as she hands it to you. "Give it to the kiosk guy. He owes me."

>give paper to kiosk guy
You firmly place the paper scrap onto the kiosk desk. The man looks up from his book, and takes it. He unfolds the paper, and the corner of his mouth tugs upward. He turns to the cash register, and takes out a wad of cash, carefully counting it before he hands it to you. He does not say a word, and returns to his book.

>give cash to conductor
(Conductor)
You hand the Conductor the wad of cash. He flips through, quickly counting it, and nods.

"Alright. You're good to go!" You cringe on the inside. This corruption is not unfamiliar to you, but to engage in it yourself... it's so wrong. "ALL ABOARD!" He yells, and steps South, into the Train.

>s
the Sliding Door slides shut just as you leap into the Train Entrance car. You hear the train whir to life. Suddenly, you feel yourself stumble backwards, and find that outside, the scenery begins flying past. You hear the Conductor's voice again: "Hello everybody. We are now headed to the City. Relax, and enjoy your time during this journey."

Train Entrance
A rather small room with little furnishing. The walls are made mostly of polished wood, and below you is a dark purple carpet. The Passenger Car is Eastward. 

You can see Sir Allan here.

>e
Passenger Car
There are about 30 open seats uniformly lined up across the room, but only a few are occupied. This should be where everybody sits during the majority of the journey. To the East is the Observation Car, and North is the Toilet.

You can see Mark and Audrey here.

>talk to mark
He is sleeping in one of the seats. You probably shouldn't disturb him.

>n
The door is locked shut. You politely knock once. After a long minute of silence, you knock again. This time, you yell, "Is anybody there?!" Silence. You push the door with a bit of force.

"What in the world?" You slam your body against the door. You hear a slight crack.

You push again, and the lock breaks with a resounding clap. The door swings open and reveals the bathroom.

Bathroom
A cramped single toilet room with one toilet and one sink. Opposite of the door is an open window. At the center of the bathroom is a horrible sight: Felix's body is sprawled out on the floor. He is dead. 

You can see Corpse here.

>n
You can't go that way.

>take jewel
You can't see any such thing.

>undo
Bathroom
[Previous turn undone.]

>undo
Bathroom
[Previous turn undone.]

>undo
Passenger Car
[Previous turn undone.]

>n
The door is locked shut. You politely knock once. After a long minute of silence, you knock again. This time, you yell, "Is anybody there?!" Silence. You push the door with a bit of force.

"What in the world?" You slam your body against the door. You hear a slight crack.

You push again, and the lock breaks with a resounding clap. The door swings open and reveals the bathroom.

Bathroom
A cramped single toilet room with one toilet and one sink. Opposite of the door is an open window. At the center of the bathroom is a horrible sight: Felix's body is sprawled out on the floor. He is dead. 

You can see Corpse here.

* * *

>n
You can't go that way.

>x jewel
You can't see any such thing.

* * *

>x bed
Your sheets are tangled into a ball at the foot of the mattress. In contrast, your pillow sits neatly at the front of the bed. The twin sized bed, meant for children, is made of a light brown wood. You brought it to your cottage after moving out of your parent's house, for there was no reason to throw it away.

>x pillow
When you were a child, you fell asleep on a rice bag and discovered that it was the only pillow that could give you a restful night. Since then, you've always preferred the lumpy hard pillow over feather pillows.

>x kitche
You can't see any such thing.

>x kitchen
Super simplistic. Consists of only a sink and a stove.

>x stove
Occasionally you dabble in some cooking, and you're quite good at it too. The neighbors often ask for recipes and tips, which you willingly give. The stove itself is quite old, as you bought it from a second hand store.

* * *

>x sink
A year ago, the mayor cut off all water from the pipes to prevent the Company's factory from working. Although it was inconvenient, the town's residents all agreed that we needed to send a warning to the Company.

>x table
A round wooden table that you constructed out of the spare wood pile from the carpenter. It serves as your desk and dining table. At the center of the table is a polished purple stone.

>x stone
The townspeople call it Cloud Stone. The opaque material is an intense purple, mixed with greys and whites. The colors swirls into intricate patterns that almost look artificially enhanced. Just two years ago, there were only a couple of stones that a select few families held. But then the Company discovered the precious materials, and began digging deep into the villager's farms. There, they found masses of the Cloud Stone, which they called Charoite. Shortly after, they offered a huge sum of money to the town's mayor, hoping that he would allow the Company to keep digging. The mayor refused.

* * *

>take stone
Taken.

>e
Town Square
A square plaza with a cobblestone ground. Along the sides of the square are many two-story buildings. At the center of the square is a tall stone fountain, encircled by several wooden benches. Your cottage is to the West. East is the Mayor's House. There is a crowd gathered outside the Mayor's House.

>x ground
Medium sized rocks lay in a circular pattern around the fountain.

>x buildings
Two-story buildings line the side of the square. These buildings contain homes, stores, and restaurants. The stores and restaurants are all closed, but dim lights illuminate the windows.

>x fountain
The sculpture makes as a humble fountain, but radiates an aura of tranquility. The smooth stone features a woman carrying a flower in one hand and a rock in the other.

>x benches
Plain wooden benches meant for decoration. Years ago when you were a small child, you would stand on these benches and haughtily beam over your friend's heads. You were the king of the world!

>w
Cottage
A small one room compartment. Shoved into the corner of the room is your bed. Next to the door is your sorry excuse of a kitchen: a small stove, and a sink. At the center of the room is a squat wooden table with the stone on it. On the wall above your sink is a small one way window that looks into Town Square. You can go to Town Square by going East.

* * *

>x crowd
The crowd consists of angry village women and men. They hold pitchforks and shovel; you cannot see what's happening as they are too tall.

>get on benches
You get onto Benches.

After stepping onto the bench, you take a look over the crowd. What you see does not surprise you. A young man in a black suit stands proudly at the center of the crowd, a smirk corrupting his handsome face. This man is Edgar, a representative of the Company. Next to him, the Mayor angrily faces him. He looks like he wants to punch Edgar right then and there, but is holding back for some reason.

>x edgar
Edgar is a handsome man. Although the Company has been around town for more than ten years, Edgar has not aged one bit.

>x mayor
A man in his fifties. He has been mayor since you were a child. You remember how he proudly took on the title back then. You realize the job has taken quite a toll on him, as his hair and beard has turned almost completely grey. His stomach, once quite fit, has become a potbelly, threatening to burst his black suit.

>talk to edgar
You yell out at Edgar, but your voice is lost in the shouts of the other villagers.

* * *

>x floor
The marble floor seems to glow, its color resembling moonlight.

>x table
A large wooden table sits in the middle of the room.  It is glossy and beautifully curved, topped with an opaque glass surface.

>x painting
The subject in the painting is the Mayor. The painting depicts the Mayor in his earlier governing days, when he was young and fit. The stark contrast between the painting and the Mayor today show just how much of a toll the job has taken on him.

* * *

>x sofa
A pale earth colored leather sofa. The Mayor sits heavily on the wrinkled material.

>x mayor
A man in his fifties. He has been mayor since you were a child. You remember how he proudly took on the title back then. You realize the job has taken quite a toll on him, as his hair and beard has turned almost completely grey. His stomach, once quite fit, has become a potbelly, threatening to burst his black suit.

>talk to mayor
"Mayor, I think we need to hurry." The Mayor closes his eyes.

"Yes," he murmurs, "We should. Alex, I need you to chase my son. I am well past my prime, and cannot leave the villagers. Heaven only knows what they would do if I walked away from the town. Please go to the Station and save my son." You nod dutifully, and walk to the exit.

Station
The Station is slow and idle. The town is not an attraction, and the Station is merely a stop for business men who need work in the city, or visit home. You see only a few business men walking around, luggages in tow. Prominently in the center of the station is a large faded red ticket booth. Next to it is a small kiosk, selling beverages and food items. To the south is the Train, waiting to depart.  Leaning against one of the pillars is a tall lanky boy, who you recognize instantly: Felix. Next to him is a man in a black suit, who Felix merrily jokes with. What in the world?

You can see Black Suit and Felix here.

>x business men
The men, all in monotonous grey suits, trudge around the Station, dragging suitcases or luggages behind them. They are usually salarymen, seeking jobs in the distant cities to support their families here in the country.

>x ticket booth
A squat boxy room standing in the middle of the station. The ticket booth is old, its bright red color faded from years of neglect. On its faded walls are years of expired promotion posters, graffiti, and dried gum. Its windows are dirty and unclean, but a clean piece of paper is pasted on the glass-a train table. Behind the counter sits a bored woman. On closer inspection, you realize that the woman is a villager named Rita.

>x kiosk
(Kiosk)
A small kiosk, selling beverages and food items. Sitting by the counter is a haggard looking guy.

>l
Station
The Station is slow and idle. The town is not an attraction, and the Station is merely a stop for business men who need work in the city, or visit home. You see only a few business men walking around, luggages in tow. Prominently in the center of the station is a large faded red ticket booth. Next to it is a small kiosk, selling beverages and food items. To the south is the Train, waiting to depart.  Leaning against one of the pillars is a tall lanky boy, who you recognize instantly: Felix. Next to him is a man in a black suit, who Felix merrily jokes with. What in the world?

You can see Black Suit and Felix here.

>s
You walk up to the Train Conductor, an elderly man with a sneer on his face. You say,

"Ah. Hello. I need to get on the train."

"Do you have a ticket?" He asks. You shake your head.

"Do you have anything else that can get you on the train?" He opens his palm towards you, facing upwards.

>s
You walk up to the Train Conductor, an elderly man with a sneer on his face. You say,

"Ah. Hello. I need to get on the train."

"Do you have a ticket?" He asks. You shake your head.

"Do you have anything else that can get you on the train?" He opens his palm towards you, facing upwards.

* * *

>i
You are carrying:
  Purple Stone

>give purple stone to conductor
(Conductor)
Conductor doesn't seem interested.

>l
Station
The Station is slow and idle. The town is not an attraction, and the Station is merely a stop for business men who need work in the city, or visit home. You see only a few business men walking around, luggages in tow. Prominently in the center of the station is a large faded red ticket booth. Next to it is a small kiosk, selling beverages and food items. To the south is the Train, waiting to depart.  Leaning against one of the pillars is a tall lanky boy, who you recognize instantly: Felix. Next to him is a man in a black suit, who Felix merrily jokes with. What in the world?

You can see Black Suit and Felix here.

>x feli
You can't see any such thing.

>x felix
A tall boy, who just turned 18 in the fall. He cooly leans against the a concrete pillar, an aura of youthful arrogance and hopefulness surrounds him. His hair is cropped closely to his narrow face and evenly combed. Freckles are splattered over his nose, and his mouth naturally curves up into a faint smile. He is dressed smartly in a light grey suit, with a black tie.

>x briefcase
You can't see any such thing.

>talk to felix
You stride towards Felix, and slap him across the face. He is dumbfounded for a moment before registering who you are. He gestures apologetically to the the men in suits and they walk away.

"What are you doing?" You shout at him.

"I'm going to the city, Alex," he retorts. "I'm sick of that stupid village. I don't want to inherit the position of mayor when I have the potential to do so much more. Luckily, the Company realized this and offered to relocate me. They're bringing me to the city, it's going to be wonderful!"

"You don't understand. Right now the Company has told your father that they are holding you in their custody. They said that if the villagers don't yield all of the Cloud Stones, they'll harm you."

"Don't joke with me. That old fart's probably willing to say anything to get me back to the village. And once they do, they'll never let me leave again."

"Shut up! If the villagers do end up handing over the stones, they'll capture you and toss you back into the village. Please Felix, come to your sense."

"No! I can't stay there. Even if your story is true, the villagers would never hand over the stupid rocks. They have too much pride for that!" The speakers in the Station suddenly blare out:

"Train 342 to the City is departing in 10 minutes-please board now. Thank you." Felix looks at you, then shoves you out of the way to gather his belongings.

>l
Station
The Station is slow and idle. The town is not an attraction, and the Station is merely a stop for business men who need work in the city, or visit home. You see only a few business men walking around, luggages in tow. Prominently in the center of the station is a large faded red ticket booth. Next to it is a small kiosk, selling beverages and food items. To the south is the Train, waiting to depart.  Leaning against one of the pillars is a tall lanky boy, who you recognize instantly: Felix. Next to him is a man in a black suit, who Felix merrily jokes with. What in the world?

You can see Felix here.

>x booth
A squat boxy room standing in the middle of the station. The ticket booth is old, its bright red color faded from years of neglect. On its faded walls are years of expired promotion posters, graffiti, and dried gum. Its windows are dirty and unclean, but a clean piece of paper is pasted on the glass-a train table. Behind the counter sits a bored woman. On closer inspection, you realize that the woman is a villager named Rita.

>talk to rita
You walk up to the counter, and say,

"Hi Ms. Rita. Long time no see, how have you been?" Her eyes focus, and she smiles grimly.

"Hello Austin,"

"Alex", you correct.

"Alex. You know, same old same old. How's ya mother? She good?" You nod.

"Yep. Uh, listen Rita. I need a ticket onto that train over there. How much does it cost?"

"Sorry, boy. Tickets are all sold out. Budget cuts, ya know? They're limiting passengers to lighten the load." You raise your brow. Budget cuts?

"This is really important. The Company's done something real bad this time."

"The Company?" Rita's eyes bulge, "Oh dear. Uh... Oh! You see the Conductor over there? Sometimes he allows some extra people onto the train in exchange for something in return. Ya know what I mean?"

"How much?"

"$20 dollahs."

"20!? That's daylight robbery!" Ignoring you, she grabs a piece of scrap paper from her cluttered desk and scrawls something on it.

"Here," Rita says as she hands it to you. "Give it to the kiosk guy. He owes me."

>talk to black suit
You can't see any such thing.

>l
Station
The Station is slow and idle. The town is not an attraction, and the Station is merely a stop for business men who need work in the city, or visit home. You see only a few business men walking around, luggages in tow. Prominently in the center of the station is a large faded red ticket booth. Next to it is a small kiosk, selling beverages and food items. To the south is the Train, waiting to depart.  Leaning against one of the pillars is a tall lanky boy, who you recognize instantly: Felix. Next to him is a man in a black suit, who Felix merrily jokes with. What in the world?

You can see Felix here.

>talk to felix
You stride towards Felix, and slap him across the face. He is dumbfounded for a moment before registering who you are. He gestures apologetically to the the men in suits and they walk away.

"What are you doing?" You shout at him.

"I'm going to the city, Alex," he retorts. "I'm sick of that stupid village. I don't want to inherit the position of mayor when I have the potential to do so much more. Luckily, the Company realized this and offered to relocate me. They're bringing me to the city, it's going to be wonderful!"

"You don't understand. Right now the Company has told your father that they are holding you in their custody. They said that if the villagers don't yield all of the Cloud Stones, they'll harm you."

"Don't joke with me. That old fart's probably willing to say anything to get me back to the village. And once they do, they'll never let me leave again."

"Shut up! If the villagers do end up handing over the stones, they'll capture you and toss you back into the village. Please Felix, come to your sense."

"No! I can't stay there. Even if your story is true, the villagers would never hand over the stupid rocks. They have too much pride for that!" The speakers in the Station suddenly blare out:

"Train 342 to the City is departing in 10 minutes-please board now. Thank you." Felix looks at you, then shoves you out of the way to gather his belongings.

>i
You are carrying:
  Paper Scrap
  Purple Stone

>x paper scrap
The white scrap of paper is folded. You open it and there's a large six pointed star drawn in the center, with the number 20 written on it. You wonder what kind of favor this guy owes Rita.

>give paper to guy
You firmly place the paper scrap onto the kiosk desk. The man looks up from his book, and takes it. He unfolds the paper, and the corner of his mouth tugs upward. He turns to the cash register, and takes out a wad of cash, carefully counting it before he hands it to you. He does not say a word, and returns to his book.

>talk to guy
You approach the Kiosk Guy, who is intently reading his book. You say, "Uh. Hello. Can you help me?"

He immediately looks up. The glare in his face startles you, and you back away.

>talk to conductor
(Conductor)
You walk up to the Train Conductor, an elderly man with a sneer on his face. You say,

"Ah. Hello. I need to get on the train."

"Do you have a ticket?" He asks. You shake your head.

"Do you have anything else that can get you on the train?" He opens his palm towards you, facing upwards.

>i
You are carrying:
  Wad of Cash
  Purple Stone

>x cash
You flip through the wad of cash and find a total of 15 one dollar bills and a five dollar bill.

>give cash to conductor
(Conductor)
You hand the Conductor the wad of cash. He flips through, quickly counting it, and nods.

"Alright. You're good to go!" You cringe on the inside. This corruption is not unfamiliar to you, but to engage in it yourself... it's so wrong. "ALL ABOARD!" He yells, and steps inside the Train.

>l
Station
The Station is slow and idle. The town is not an attraction, and the Station is merely a stop for business men who need work in the city, or visit home. You see only a few business men walking around, luggages in tow. Prominently in the center of the station is a large faded red ticket booth. Next to it is a small kiosk, selling beverages and food items. To the south is the Train, waiting to depart.

>s
the Sliding Door slides shut just as you leap into the Train Entrance car. You hear the train whir to life. Suddenly, you feel yourself stumble backwards, and find that outside, the scenery begins flying past. You hear the Conductor's voice again: "Hello everybody. We are now headed to the City. Relax, and enjoy your time during this journey."

Train Entrance
A rather small room with little furnishing. The walls are made mostly of polished wood, and the floor is covered with a dark purple carpet. The Passenger Car is Eastward. 

You can see Sir Allan here.

>x wood
You can't see any such thing.

>x walls
You can't see any such thing.

>x carpet
A dark purple carpet. There are a few stains here and there, but it is mostly clean.

>talk to sir allan
 You politely wave at Sir Allan, and he waves back. He approaches you inquires,

"Might you be a local here?" You nod. "Interesting. I've just come from the countryside after a wonderful vacation there, at my villa. I was born there, you know, in the spring of 1942. Back then, we were in the midst of the War. My father went to fight, but he never came back," you nod as Sir Allan elaborates his life story to you. He beams as he talks about his rise to wealth from poverty. You zone out, and eventually Sir Allan stops talking.

>l
Train Entrance
A rather small room with little furnishing. The walls are made mostly of polished wood, and the floor is covered with a dark purple carpet. The Passenger Car is Eastward. 

You can see Sir Allan here.

>e
Passenger Car
There are about 30 open seats uniformly lined up across the room, but only a few are occupied. This should be where everybody sits during the majority of the journey. To the East is the Observation Car, and North is the Toilet.

You can see Mark and Audrey here.

>x seats
Purple cotton seats that are slightly soiled from use.

>talk to mark
He is sleeping in one of the seats. You probably shouldn't disturb him.

>x mark
A dark haired man, probably around 25 years old. His tanned and calloused hands betray his arduous labor job. Mark wears a cotton vest over a white button-up shirt.

>talk to audrey
Audrey paces by the bathroom, as if she really needs to go. She grumbles that the person inside has been in there for over half an hour. You talk to her, and she gives you a small smile,

"I would talk to you, but my bladder is quite uncomfortable right now."

>e
Observation Car
A long with glass window on the walls and ceiling. There are several couches facing the windows, so that people can watch the beautiful scenery fly by. 

You can see Black Suit and Luna here.

>talk to black suit
You approach Black Suit again, and he grunts.

"Where is Felix?" You demand.

"If I knew, I wouldn't be here looking for him! I don't know. He went to the restroom and never came back." You silently mention to yourself that Black Suit is not looking, but pacing about. How productive.

>x windows
The clear glass windows replace the walls of the train. Light floods into the room, and the everything is tranquil. Through the windows, you watch the green countryside fly past.

>talk to luna
You politely wave at Luna, and she waves back.

"Alex! What are you doing here?" she exclaims. You tell her about the Mayor's order,

"The Mayor told me to come and find Alex. But I can't seem to find him at all. What about you? Where are you headed to?"

"I was there this morning, and I've decided to travel to the city for legal help. If we can't push back the Company, then maybe the law can.

.

>l
Observation Car
A long with glass window on the walls and ceiling. There are several couches facing the windows, so that people can watch the beautiful scenery fly by. 

You can see Black Suit and Luna here.

>x novel
A brand new romance novel. Luna said that she was reading it, it might be evidence.

>undo
Observation Car
[Previous turn undone.]

>x window
You can't see any such thing.

>x windows
The clear glass windows replace the walls of the train. Light floods into the room, and the everything is tranquil. Through the windows, you watch the green countryside fly past.

>undo
Observation Car
[Previous turn undone.]

>x glass
The clear glass windows replace the walls of the train. Light floods into the room, and the everything is tranquil. Through the windows, you watch the green countryside fly past.

>x glass window
I only understood you as far as wanting to examine Glass Windows.

>x windows
The clear glass windows replace the walls of the train. Light floods into the room, and the everything is tranquil. Through the windows, you watch the green countryside fly past.

>l
Observation Car
A long with glass window on the walls and ceiling. There are several couches facing the windows, so that people can watch the beautiful scenery fly by. 

You can see Black Suit and Luna here.

>w
Passenger Car
There are about 30 open seats uniformly lined up across the room, but only a few are occupied. This should be where everybody sits during the majority of the journey. To the East is the Observation Car, and North is the Toilet.

You can see Mark and Audrey here.

>talk to audrey
Audrey paces by the bathroom, as if she really needs to go. She grumbles that the person inside has been in there for over half an hour. You talk to her, and she gives you a small smile,

"I would talk to you, but my bladder is quite uncomfortable right now."

>n
The door is locked shut. You politely knock once. After a long minute of silence, you knock again. This time, you yell, "Is anybody there?!" Silence. You push the door with a bit of force.

"What in the world?" You slam your body against the door. You hear a slight crack.

You push again, and the lock breaks with a resounding clap. The door swings open and reveals the bathroom.

>n
Bathroom
A cramped single toilet room with one toilet and one sink. At the center of the bathroom is a horrible sight: Felix's body is sprawled out on the floor. He is dead.  Out of the corner of your eye, you notice a small glimmer in Felix's palm. You carefully pick it up and discover that it is a small jewel.

You can see Corpse here.

>s
Passenger Car
There are about 30 open seats uniformly lined up across the room, but only a few are occupied. This should be where everybody sits during the majority of the journey.  As you walk through the isle, you see the belongings of a few people, including Mark's Backpack, Felix's Briefcase, and Sir Allan's Luggage.To the East is the Observation Car, and North is the Toilet.

You can see Mark and Audrey here.

>e
Observation Car
A long with glass window on the walls and ceiling. There are several couches facing the windows, so that people can watch the beautiful scenery fly by. On one of the couches is Luna's purse, which is placed on top of a Novel.

You can see Luna here.

* * *

>e
You can't go that way.

>w
Passenger Car
There are about 30 open seats uniformly lined up across the room, but only a few are occupied. This should be where everybody sits during the majority of the journey.  As you walk through the isle, you see the belongings of a few people, including Mark's Backpack, Felix's Briefcase, and Sir Allan's Luggage.To the East is the Observation Car, and North is the Toilet.

You can see Luna, Mark and Audrey here.

>talk to mark
 You can ask Mark about:

Himself.

The purpose of his journey.

What he was doing and where during the time of the crime.

The victim. 

 Him looking through victim's belongings.

>ask mark about him looking through victim's belongings
"I did not such thing!" He retorts. Perhaps we need to ask his wife, Audrey.

>e
Observation Car
A long with glass window on the walls and ceiling. There are several couches facing the windows, so that people can watch the beautiful scenery fly by. On one of the couches is Luna's purse, which is placed on top of a Novel.

You can see Luna's Purse (closed) here.

>e
You can't go that way.

* * *

>w
Passenger Car
There are about 30 open seats uniformly lined up across the room, but only a few are occupied. This should be where everybody sits during the majority of the journey.  As you walk through the isle, you see the belongings of a few people, including Mark's Backpack, Felix's Briefcase, and Sir Allan's Luggage.To the East is the Observation Car, and North is the Toilet.

You can see Luna, Mark and Audrey here.

>talk to audrey
You can ask Audrey about:

Herself.

The purpose of her journey.

What she was doing and where when the crime happened.

The victim. 

Her husband stealing.

I beg your pardon?

>ask audrey about her husband stealing
"No. My husband is a good man, he wouldn't do such a thing."

>x mark's backpack
A brown canvas zipper backpack. It is quite large, and occupies the whole seat.

>open mark's backpack
When you unzip it, you gasp. There are stacks of money crammed into the bag. You empty the contents on the chair and the piles of money drop out. When the back has been emptied, you notice a photograph among the bills.

>talk to audrey
You can ask Audrey about:

Herself.

The purpose of her journey.

What she was doing and where when the crime happened.

The victim. 

Her husband stealing.

$2000 dollars in Mark's possession.

>x cahs
You can't see any such thing.

>x cash
You can't see any such thing.

>open backpack
When you unzip it, you gasp. There are stacks of money crammed into the bag. You empty the contents on the chair and the piles of money drop out. When the back has been emptied, you notice a photograph among the bills.

>x cash
You can't see any such thing.

>x money
You sift through the money and quickly calculate the total to be around $2000 dollars.

>x stacks of cash
I only understood you as far as wanting to examine Stacks of Money.

>x stacks of money
You sift through the money and quickly calculate the total to be around $2000 dollars.

>take money
Taken.

>x photograph
A small photo, presumably cut out from a yearbook, of a young boy. Clipped to the photograph is piece of paper, presumably a prescription, that reads "Peter Markson: Scarlet Fever. Prescription for antibiotics."

>open backpack
When you unzip it, you gasp. There are stacks of money crammed into the bag. You empty the contents on the chair and the piles of money drop out. When the back has been emptied, you notice a photograph among the bills.

>i
You are carrying:
  Stacks of Money
  Purple Stone

>x photograph
A small photo, presumably cut out from a yearbook, of a young boy. Clipped to the photograph is piece of paper, presumably a prescription, that reads "Peter Markson: Scarlet Fever. Prescription for antibiotics."

>drop money
This is evidence of Mark's theft. It may have something to do with the murder.

>talk to audrey
You can ask Audrey about:

Herself.

The purpose of her journey.

What she was doing and where when the crime happened.

The victim. 

Her husband stealing.

$2000 dollars in Mark's possession.

>ask audrey about $2000 dollars in Mark's possession
Audrey's eyes widen at the mention of $2000 dollars.

"$2000... that's the price of the medicine," she breathes. "Our son's medicine. Mark must've... Oh dear."

>talk to mark
 You can ask Mark about:

Himself.

The purpose of his journey.

What he was doing and where during the time of the crime.

The victim. 

 Him stealing money from victim to pay for son's medication.

>ask mark  about Him stealing money from victim to pay for son's medication
You confront Mark, telling him that you know he stole the money to pay for his son's medicine.

"Okay, okay. I saw the money in the briefcase, and I just took it. My son is desperately sick, and I fear that once I pay for the medicine, I won't be able to feed my family."

>ask mark about the victim
"I did see the victim arguing with Sir Allan."

>l
Passenger Car
There are about 30 open seats uniformly lined up across the room, but only a few are occupied. This should be where everybody sits during the majority of the journey.  As you walk through the isle, you see the belongings of a few people, including Mark's Backpack, Felix's Briefcase, and Sir Allan's Luggage.To the East is the Observation Car, and North is the Toilet.

You can see Luna, Mark and Audrey here.

>e
Observation Car
A long with glass window on the walls and ceiling. There are several couches facing the windows, so that people can watch the beautiful scenery fly by. On one of the couches is Luna's purse, which is placed on top of a Novel.

You can see Luna's Purse (closed) here.

>w
Passenger Car
There are about 30 open seats uniformly lined up across the room, but only a few are occupied. This should be where everybody sits during the majority of the journey.  As you walk through the isle, you see the belongings of a few people, including Mark's Backpack, Felix's Briefcase, and Sir Allan's Luggage.To the East is the Observation Car, and North is the Toilet.

You can see Luna, Mark and Audrey here.

>w
Train Entrance
A rather small room with little furnishing. The walls are made mostly of polished wood, and the floor is covered with a dark purple carpet. The Passenger Car is Eastward. 

You can see Black Suit and Sir Allan here.

>talk to sir allan
 

You can ask Sir Allan about:

Himself.

The purpose of his journey.

What he was doing and where during the time of the crime.

The victim. 

His argument with the victim.

>ask sir allan about his argument with the victim
sir allan is taken aback, but regains his composure quickly. he says that he suspected that felix stole a $50 dollar bill from his luggage, and felix said he didn't.

>e
Passenger Car
There are about 30 open seats uniformly lined up across the room, but only a few are occupied. This should be where everybody sits during the majority of the journey.  As you walk through the isle, you see the belongings of a few people, including Mark's Backpack, Felix's Briefcase, and Sir Allan's Luggage.To the East is the Observation Car, and North is the Toilet.

You can see Luna, Mark and Audrey here.

>x sir allan's luggage
A black cotton canvas luggage bag. Sir Allan's Luggage Bag is tucked into the corner of a rack.

>open sir allan's luggage
 You unzip the luggage, and glance through its contents. Inside, there are a number of notebooks and files. Strange for a man who has retired. Suddenly, you notice a Purple Notebook with a familiar swirling pattern.

>open luggage
 You unzip the luggage, and glance through its contents. Inside, there are a number of notebooks and files. Strange for a man who has retired. Suddenly, you notice a Purple Notebook with a familiar swirling pattern.

>open sir allan's luggage
 You unzip the luggage, and glance through its contents. Inside, there are a number of notebooks and files. Strange for a man who has retired. Suddenly, you notice a Purple Notebook with a familiar swirling pattern.

>x notebook
The cover of the notebook contains a familiar pattern. You take out your Cloud Stone and find that the designs look awfully similar. Perhaps you should take it first, then read through it.

>x purple notebook
The cover of the notebook contains a familiar pattern. You take out your Cloud Stone and find that the designs look awfully similar. Perhaps you should take it first, then read through it.

>read notebook
Start by reading page 1 of Purple Notebook.

>read page 1 of notebook
You're not reading anything.

>take purple notebook
Taken.

>read page 1 of notebook
You read: "We have discovered Charoite at one of the factory sites. Mining and selling the charoite would produce 940% profit."

>next
That's not a verb I recognise.

>read next page
What do you want to read that in?

>read page 2
What do you want to read page that in?

>read page 2 of notebook
You read: "We approached the townspeople with one million dollars, hoping that they would take this meager sum in exchange for the precious stones. To our surprise, they refused with a passion. The local mayor shut down the factory and kicked us out. This does not do well."

>read page 3 of notebook
You read: "As the CEO, I have been advised to use more... cunning means to attain the charoite. They propose that we bait the mayor's son into our possession and use him to bargain. I have already communicated with the boy, and he has fallen for the trap. Soon, we will have the stones. The Company will certainly profit greatly."

>read page 4 of notebook
You read: "On the last page is a detailed drawing of a Cloud Stone. Calculations and notes about the stone are scribbled on the margins."

>e
Observation Car
A long with glass window on the walls and ceiling. There are several couches facing the windows, so that people can watch the beautiful scenery fly by. On one of the couches is Luna's purse, which is placed on top of a Novel.

You can see Luna's Purse (closed) here.

* * *

>w
Train Entrance
A rather small room with little furnishing. The walls are made mostly of polished wood, and the floor is covered with a dark purple carpet. The Passenger Car is Eastward. 

You can see Black Suit and Sir Allan here.

>talk to sir allan
 

You can ask Sir Allan about:

Himself.

The purpose of his journey.

What he was doing and where during the time of the crime.

The victim. 

 Being the CEO of the Company.

>Ask Sir Allan about being the CEO of the Company
You angrily rush up to Sir Allan, demanding to know whether or not Sir Allan is really the CEO of the Company, which has plagued your home for years. "You! YOU'RE the CEO of the Company?" A look of surprise contorts Sir Allan's face, but he quickly regains his composure.

"No. I told you, I'm a retired old man returning to the city after a vacation."

"Would a retired old man have detailed reports of my hometown, that just so happen to be regarding a precious stone the Company seeks? Spit it out you old man."

"Well, I suppose you know now. There's really nothing else to say."

"Actually. There is. Did you kill Felix?" Sir Allan raises his brow in amusement.

"Now even if I did, I wouldn't tell you. But no, I did not kill Felix. I had no reason to. What would I gain from killing him? In fact, I would actually need the stupid boy alive to get the charoite. It wasn't us, I can tell you that. What happened was a tragedy, and now I have lost leverage on the Mayor. Damn it all.

>e
Passenger Car
There are about 30 open seats uniformly lined up across the room, but only a few are occupied. This should be where everybody sits during the majority of the journey.  As you walk through the isle, you see the belongings of a few people, including Mark's Backpack, Felix's Briefcase, and Sir Allan's Luggage.To the East is the Observation Car, and North is the Toilet.

You can see Luna, Mark and Audrey here.

>e
Observation Car
A long with glass window on the walls and ceiling. There are several couches facing the windows, so that people can watch the beautiful scenery fly by. On one of the couches is Luna's purse, which is placed on top of a Novel.

You can see Luna's Purse (closed) here.

* * *

>i
You are carrying nothing.

>l
Cottage
A small one room compartment. Shoved into the corner of the room is your bed. Next to the door is your sorry excuse of a kitchen: a small stove, and a sink. At the center of the room is a squat wooden table. On the wall above your sink is a small one way window that looks into Town Square. You can go to Town Square by going East.

>x table
A round wooden table that you constructed out of the spare wood pile from the carpenter. It serves as your desk and dining table. At the center of the table is a polished purple stone.

>x stne
You can't see any such thing.

>x stone
The townspeople call it Cloud Stone. The opaque material is an intense purple, mixed with greys and whites. The colors swirls into intricate patterns that almost look artificially enhanced. Just two years ago, there were only a couple of stones that a select few families held. But then the Company discovered the precious materials, and began digging deep into the villager's farms. There, they found masses of the Cloud Stone, which they called Charoite. Shortly after, they offered a huge sum of money to the town's Mayor, hoping that he would allow the Company to keep digging. The Mayor refused.

* * *

>e
Town Square
A square plaza with a cobblestone ground. Along the sides of the square are many two-story buildings. At the center of the square is a tall stone fountain, encircled by several wooden benches. Your cottage is to the West. East is the Mayor's House. There is a crowd gathered outside the Mayor's House.

>x benches
Plain wooden benches meant for decoration. Years ago when you were a small child, you would stand on these benches and haughtily beam over your friend's heads. You were the king of the world!

* * *

>stand on benches
You get onto Benches.

After stepping onto the bench, you take a look over the crowd. What you see does not surprise you. A young man in a black suit stands proudly at the center of the crowd, a smirk corrupting his handsome face. This man is Edgar, a representative of the Company. Next to him, the Mayor angrily faces him. He looks like he wants to punch Edgar right then and there, but is holding back for some reason.

>faountain
That's not a verb I recognise.

>x fountain
The sculpture makes as a humble fountain, but radiates an aura of tranquility. The smooth stone features a woman carrying a flower in one hand and a rock in the other.

>x flower
You can't see any such thing.

>x statue
You can't see any such thing.

>e
You pull the on the brass handle, but the door appears to be locked. Plus, it's not your home-you shouldn't go in without permission.

>x edgar
Edgar is a handsome man. Although the Company has been around town for more than ten years, Edgar has not aged one bit.

>take edgar
I don't suppose Edgar would care for that.

>take mayor
I don't suppose Mayor would care for that.

>talk to mayor
You push and squeeze through the crowd of angry villagers until you come to the Mayor. He does not even notice you until you shake him roughly on the shoulder. You have to shout for him to hear you, "Sir, what is happening?"

"Him," he points to Edgar. "He just informed us that the Company has Felix."

You are taken aback. They have Felix?

"Your son, Felix?"

"Who else?!" The mayor cries angrily. "They want the damn rocks! Now they've resorted to this trickery and blackmailing. What villains!"

"What can we do?" You ask earnestly.

"I don't know," he says as he shakes his head, "Why don't we go into the house to speak."

"Alright." The mayor turns to Edgar and says in his booming voice,

"Enough!" The crowd goes silent. "Edgar. We will give you an answer soon. In the meantime, at least tell me where my son is."

Edgar laughs. "Now? Probably on the way to the City. I will await your reply," he cackles as he walks away. The mob of villagers glare at Edgar, as he arrogantly strides away. When he is out of sight, the villagers begin to head back to their homes, grumbling to themselves.

You turn to the Mayor and he unlocks the door to his house. You follow him into the spacious mansion.

Mayor's House
When you walk into the house, you are stunned by the beautiful furnishing that seems to glitter in the house. At the center of the pearly marble white floor is a large glossy wooden table. Under a magnificent acrylic painting is a polished large leather sofa. The Mayor plops down on the sofa and deflates.

>ask mayor about felix
There is no reply.

>talk to mayor
"Mayor, I think we need to hurry." The Mayor closes his eyes.

"Yes," he murmurs, "We should. Alex, I need you to chase my son. I am well past my prime, and cannot leave the villagers. Heaven only knows what they would do if I walked away from the town. Please go to the Station and save my son." You nod dutifully, and walk to the exit.

Station
The Station is slow and idle. The town is not an attraction, and the Station is merely a stop for business men who need work in the city, or visit home. You see only a few business men walking around, luggages in tow. Prominently in the center of the station is a large faded red ticket booth. Next to it is a small kiosk, selling beverages and food items. To the south is the Train, waiting to depart.  Leaning against one of the pillars is a tall lanky boy, who you recognize instantly: Felix. Next to him is a man in a black suit, who Felix merrily jokes with. What in the world?

You can see Black Suit and Felix here.

* * *

>punch felix
Violence isn't the answer to this one.

>punch edgar
Violence isn't the answer to this one.

>talk edgar
I didn't understand that sentence.

>talk to black suit
You greet the man in the Black Suit, but he looks at you and you immediately stop talking- you can't help it. Something about this man screams ominous, and you are frightened.

>i
You are carrying:
  Purple Stone

>l
Station
The Station is slow and idle. The town is not an attraction, and the Station is merely a stop for business men who need work in the city, or visit home. You see only a few business men walking around, luggages in tow. Prominently in the center of the station is a large faded red ticket booth. Next to it is a small kiosk, selling beverages and food items. To the south is the Train, waiting to depart.  Leaning against one of the pillars is a tall lanky boy, who you recognize instantly: Felix. Next to him is a man in a black suit, who Felix merrily jokes with. What in the world?

You can see Black Suit and Felix here.

* * *

>s
You walk up to the Train Conductor, an elderly man with a sneer on his face. You say,

"Ah. Hello. I need to get on the train."

"Do you have a ticket?" He asks. You shake your head.

"Do you have anything else that can get you on the train?" He opens his palm towards you, facing upwards.

>give stoe
You can't see any such thing.

>show stoe
You can't see any such thing.

>show stone
Whom do you want to show Purple Stone to?

>show stone to onductor
You can't see any such thing.

>show stone to conductor
(Conductor)
Conductor is unimpressed.

>x ticket booth
A squat boxy room standing in the middle of the station. The ticket booth is old, its bright red color faded from years of neglect. On its faded walls are years of expired promotion posters, graffiti, and dried gum. Its windows are dirty and unclean, but a clean piece of paper is pasted on the glass-a train table. Behind the counter sits a bored woman. On closer inspection, you realize that the woman is a villager named Rita.

>talk rita
I didn't understand that sentence.

>talk to rita
You walk up to the counter, and say,

"Hi Ms. Rita. Long time no see, how have you been?" Her eyes focus, and she smiles grimly.

"Hello Austin,"

"Alex", you correct.

"Alex. You know, same old same old. How's ya mother? She good?" You nod.

"Yep. Uh, listen Rita. I need a ticket onto that train over there. How much does it cost?"

"Sorry, boy. Tickets are all sold out. Budget cuts, ya know? They're limiting passengers to lighten the load." You raise your brow. Budget cuts?

"This is really important. The Company's done something real bad this time."

"The Company?" Rita's eyes bulge, "Oh dear. Uh... Oh! You see the Conductor over there? Sometimes he allows some extra people onto the train in exchange for something in return. Ya know what I mean?"

"How much?"

"20 dollahs."

"20!? That's daylight robbery!" Ignoring you, she grabs a piece of scrap paper from her cluttered desk and scrawls something on it.

"Here," Rita says as she hands it to you. "Give it to the kiosk guy. He owes me."

>x kiosk
(Kiosk)
A small kiosk, selling beverages and food items. Sitting by the counter is a haggard looking guy.

>give note to kiosk guy
You can't see any such thing.

>give note to kiosk
You can't see any such thing.

>go to kiosk
You can't see any such thing.

>give note to guy
You can't see any such thing.

>give paper to guy
You firmly place the paper scrap onto the kiosk desk. The man looks up from his book, and takes it. He unfolds the paper, and the corner of his mouth tugs upward. He turns to the cash register, and takes out a wad of cash, carefully counting it before he hands it to you. He does not say a word, and returns to his book.

>i
You are carrying:
  Wad of Cash
  Purple Stone

>give cash to conductor
(Conductor)
You hand the Conductor the wad of cash. He flips through, quickly counting it, and nods.

"Alright. You're good to go!" You cringe on the inside. This corruption is not unfamiliar to you, but to engage in it yourself... it's so wrong. "ALL ABOARD!" He yells, and steps South, into the Train.

* * *

>s
the Sliding Door slides shut just as you leap into the Train Entrance car. You hear the train whir to life. Suddenly, you feel yourself stumble backwards, and find that outside, the scenery begins flying past. You hear the Conductor's voice again: "Hello everybody. We are now headed to the City. Relax, and enjoy your time during this journey."

Train Entrance
A rather small room with little furnishing. The walls are made mostly of polished wood, and below you is a dark purple carpet. The Passenger Car is Eastward. 

You can see Sir Allan here.

>talk to sir allan
 You politely wave at Sir Allan, and he waves back. He approaches you inquires,

"Hello! I've just come from the countryside after a wonderful vacation there, at my villa. I was born there, you know, in the spring of 1942. Back then, we were in the midst of the War. My father went to fight, but he never came back," you nod as Sir Allan elaborates his life story to you. He beams as he talks about his rise to wealth from poverty. You zone out, and eventually Sir Allan stops talking.

>x
(Purple Stone)
The townspeople call it Cloud Stone. The opaque material is an intense purple, mixed with greys and whites. The colors swirls into intricate patterns that almost look artificially enhanced. Just two years ago, there were only a couple of stones that a select few families held. But then the Company discovered the precious materials, and began digging deep into the villager's farms. There, they found masses of the Cloud Stone, which they called Charoite. Shortly after, they offered a huge sum of money to the town's Mayor, hoping that he would allow the Company to keep digging. The Mayor refused.

>x train
You can't see any such thing.

>e
Passenger Car
There are about 30 open seats uniformly lined up across the room, but only a few are occupied. This should be where everybody sits during the majority of the journey. To the East is the Observation Car, and North is the Toilet.

You can see Mark and Audrey here.

>talk mark
I didn't understand that sentence.

>talk to mark
He is sleeping in one of the seats. You probably shouldn't disturb him.

>talk to audrey
Audrey paces by the bathroom, as if she really needs to go. She grumbles that the person inside has been in there for over half an hour. You talk to her, and she gives you a small smile,

"I would talk to you, but my bladder is quite uncomfortable right now."

>x bathroom
You can't see any such thing.

>n
The door is locked shut. You politely knock once. After a long minute of silence, you knock again. This time, you yell, "Is anybody there?!" Silence. You push the door with a bit of force.

"What in the world?" You slam your body against the door. You hear a slight crack.

You push again, and the lock breaks with a resounding clap. The door swings open and reveals the bathroom.

Bathroom
A cramped single toilet room with one toilet and one sink. Opposite of the door is an open window. The Passenger Car is South. At the center of the bathroom is a horrible sight: Felix's body is sprawled out on the floor. He is dead.

>x corpse
He has just recently died. His eyes are wide open, and his mouth hangs open. You notice there are red marks around Felix's neck.

>x neck
You glance at the red marks around his neck. What you see are two different markings: rope marks, and scratch marks. The rope marks look very thin, so it might have been made of a fine material. In the indent of the rope mark, you also see black dust: it is soot. The scratch marks, however, look as if they were created by Felix himself. Somebody had murdered him, and he had gone down with a fight.

>x felix's neck
You can't see any such thing.

>x bathroom
You can't see any such thing.

>x windomw
You can't see any such thing.

>x window
The window is divided in the center, and the glass panes slides open and close. On the window sill are small traces of soot.

>x soot
You can't see any such thing.

>x window sill
I only understood you as far as wanting to examine Open Window.

>x red marks
You can't see any such thing.

>search felix
You find nothing of interest.

>search bathroom
You can't see any such thing.

>search toilet
You can't see any such thing.

>x neck
You glance at the red marks around his neck. What you see are two different markings: rope marks, and scratch marks. The rope marks look very thin, so it might have been made of a fine material. In the indent of the rope mark, you also see black dust: it is soot. The scratch marks, however, look as if they were created by Felix himself. Somebody had murdered him, and he had gone down with a fight.

>x head
You can't see any such thing.

>x chest
You can't see any such thing.

>x mouth
Felix's mouth hangs open, and his tongue hangs out. You see that his tongue has dried out, and you cringe at the sight.

>x eye's
You can't see any such thing.

>x neck
You glance at the red marks around his neck. What you see are two different markings: rope marks, and scratch marks. The rope marks look very thin, so it might have been made of a fine material. In the indent of the rope mark, you also see black dust: it is soot. The scratch marks, however, look as if they were created by Felix himself. Somebody had murdered him, and he had gone down with a fight.

>x soot
You can't see any such thing.

>take black dust
You can't see any such thing.

>take soot
You can't see any such thing.

>l
Bathroom
A cramped single toilet room with one toilet and one sink. Opposite of the door is an open window. The Passenger Car is South. At the center of the bathroom is a horrible sight: Felix's body is sprawled out on the floor. He is dead.

>s
Passenger Car
There are about 30 open seats uniformly lined up across the room, but only a few are occupied. This should be where everybody sits during the majority of the journey.  As you walk through the isle, you see the belongings of a few people, including Mark's Backpack, Felix's Briefcase, and Sir Allan's Luggage.To the East is the Observation Car, and North is the Toilet.

You can see Mark and Audrey here.

>talk audrey
I didn't understand that sentence.

>talk to audrey
You can ask Audrey about:

Herself.

The purpose of her journey.

What she was doing during the time of the crime.

The victim.

>talk audrey about felix
I didn't understand that sentence.

>ask audrey about felix
There is no reply.

>ask audrey about the victim
"I didn't meet the victim. But if anything, I saw Sir Allan and the victim arguing in the Passenger Car.

>ask audrey the purpose of her journey
I didn't understand that sentence.

>ask audrey about the purpose of her journey
"I'm going to the city to buy medicine for my son. He's quite sick, and we're in hurry."

>ask audrey about herself
"I'm very scared. A murder? Unthinkable. I was by my husband, Mark, the whole time. Just in case you needed to know."

>talk to mark
 You can ask Mark about:

Himself.

The purpose of his journey.

What he was doing during the time of the crime.

The victim.

>ask mark about himself
"I'm very worried. Will we have to stay on the train even after it arrives at the station? I'm in a hurry.

>ask mark about the purpose of his journey
"I'm going to the city to buy my son's medicine. He's really sick and I need to save him"

>ask mark about what he was doing during the time of the crime
"I was taking a nap in my seat. My wife can vouch for me."

>ask mark about the victim
"I did see the victim arguing with Sir Allan."

>n
Bathroom
A cramped single toilet room with one toilet and one sink. Opposite of the door is an open window. The Passenger Car is South. At the center of the bathroom is a horrible sight: Felix's body is sprawled out on the floor. He is dead.

>s
Passenger Car
There are about 30 open seats uniformly lined up across the room, but only a few are occupied. This should be where everybody sits during the majority of the journey.  As you walk through the isle, you see the belongings of a few people, including Mark's Backpack, Felix's Briefcase, and Sir Allan's Luggage.To the East is the Observation Car, and North is the Toilet.

You can see Mark and Audrey here.

>x sir allan's luggage
A black cotton canvas luggage bag. Sir Allan's Luggage Bag is tucked into the corner of a rack.

>open luggage
 You unzip the luggage, and glance through its contents. Inside, there are a number of notebooks and files. Strange for a man who has retired. Suddenly, you notice a Purple Notebook with a familiar swirling pattern.

>x notebook
The cover of the notebook contains a familiar pattern. You take out your Cloud Stone and find that the designs look awfully similar. Perhaps you should take it first, then read through it.

>take notebook
Taken.

>take files
You can't see any such thing.

>talke notebook
That's not a verb I recognise.

>take notebook
You already have that.

>x mark's backpack
A brown canvas zipper backpack. It is quite large, and occupies the whole seat.

* * *

>open briefcase
 You pull open the briefcase and peer inside: stacks and stacks of Felix's Money.

>take money
You shouldn't take it.

>i
You are carrying:
  Purple Notebook
  Purple Stone

>s
You can't go that way.

>l
Passenger Car
There are about 30 open seats uniformly lined up across the room, but only a few are occupied. This should be where everybody sits during the majority of the journey.  As you walk through the isle, you see the belongings of a few people, including Mark's Backpack, Felix's Briefcase, and Sir Allan's Luggage.To the East is the Observation Car, and North is the Toilet.

You can see Mark and Audrey here.

>e
Observation Car
A long room with glass windows on the walls. There are several couches facing the Glass Windows, so that people can watch the beautiful scenery fly by. On one of the couches is Luna's purse. The Passenger Car is west.

You can see Luna here.

>i
You are carrying:
  Purple Notebook
  Purple Stone

>climb up ladder
 Luna eyes you suspiciously, as You grip the cold metal handle and pull yourself up.

Roof
At the top of the train, you feel very unsafe. However, as you gaze at your surroundings, you are struck with admiration of the beautiful landscape. In front of you, there is a long stretch of white panels that is the roof. You notice that there is a metal rod running across the edges of each car.  Caught under the metal rod is a black card. You can go back down by climbing down the ladder.

>take black card
You can't see any such thing.

>take card
As you pick up the card, you hear a small sound behind you. There is a clink, and then everything goes black.

    *** You feel your body get thrown off the train, and then nothing. ***

Would you like to RESTART, RESTORE a saved game, QUIT or UNDO the last command?

>undo
Roof
[Previous turn undone.]

>undo
Roof
[Previous turn undone.]

>climb down ladder
You grip the cold metal handle and step down.

Observation Car
A long room with glass windows on the walls. There are several couches facing the Glass Windows, so that people can watch the beautiful scenery fly by. On one of the couches is Luna's purse. The Passenger Car is west.

You can see Luna here.

>w
Passenger Car
There are about 30 open seats uniformly lined up across the room, but only a few are occupied. This should be where everybody sits during the majority of the journey.  As you walk through the isle, you see the belongings of a few people, including Mark's Backpack, Felix's Briefcase, and Sir Allan's Luggage.To the East is the Observation Car, and North is the Toilet.

You can see Mark and Audrey here.

>e
Observation Car
A long room with glass windows on the walls. There are several couches facing the Glass Windows, so that people can watch the beautiful scenery fly by. On one of the couches is Luna's purse. The Passenger Car is west.

You can see Luna here.

>take silk belt
You can't see any such thing.

>talk to luna
You can ask Luna about:

Herself.

The purpose of her journey.

What she was doing during the time of the crime.

The victim.

Anything suspicious. 

.

>ask about anything suspicious
You can't see any such thing.

>ask luna about anything suspicious
Luna thinks for a second, then says

"Yes. I saw that guy, Mark, rummaging through Felix's," her voice cracks, "-I mean the victim's things. You know what? Sorry. I want to be alone for a bit." Luna stands up and walks west to the Passenger Car, leaving her purse behind.

>take silk belt
You can't see any such thing.

>open purse
You open the purse and rummage around. Inside, she carries a bracelet and a silk belt.

>take silk belt
You pull the Silk Belt out of the purse, and marvel at its length.

>climb up ladder
 You grip the cold metal handle and pull yourself up.

Roof
At the top of the train, you feel very unsafe. However, as you gaze at your surroundings, you are struck with admiration of the beautiful landscape. In front of you, there is a long stretch of white panels that is the roof. You notice that there is a metal rod running across the edges of each car.  You can go back down by climbing down the ladder.

>tie belt to waist
You wrap a portion of the belt around your waist, but realize that it's not attached to anything, and take off the belt.

>tie belt to metal rod
You tie the silk belt securely on the metal rod. When you pull, you are surprised by the strength the belt.

This gives you an idea. What if the murderer used the Silk Belt as a rope? They could tie it to their waist and lower themselves into the bathroom!

>tie belt to waist
 You wrap a portion of the belt around your waist. You should probably test the belt's security by pulling it.

>pull belt
You give the belt a tug, and sure enough, the belt is securely fastened to the metal rod. You carefully lower yourself on the side of the train, gripping the metal rod for support. Suddenly, your foot hits a window sill. You continue to lower yourself into the window, until you are completely in the bathroom. So this is how the murderer entered the crime scene!

Bathroom
A cramped single toilet room with one toilet and one sink. Opposite of the door is an open window. The Passenger Car is South. At the center of the bathroom is a horrible sight: Felix's body is sprawled out on the floor. He is dead.

>i
You are carrying:
  Silk Belt
  Purple Notebook
  Purple Stone

>undo
Bathroom
[Previous turn undone.]

>undo
Roof
[Previous turn undone.]

>l
Roof
At the top of the train, you feel very unsafe. However, as you gaze at your surroundings, you are struck with admiration of the beautiful landscape. In front of you, there is a long stretch of white panels that is the roof. You notice that there is a metal rod running across the edges of each car.  You can go back down by climbing down the ladder.

>pull belt
You give the belt a tug, and sure enough, the belt is securely fastened to the metal rod. You carefully lower yourself on the side of the train, gripping the metal rod for support. Suddenly, your foot hits a window sill. You continue to lower yourself into the window, until you are completely in the bathroom. So this is how the murderer entered the crime scene!

Bathroom
A cramped single toilet room with one toilet and one sink. Opposite of the door is an open window. The Passenger Car is South. At the center of the bathroom is a horrible sight: Felix's body is sprawled out on the floor. He is dead.

>undo
Roof
[Previous turn undone.]

>pull silk belt
You give the belt a tug, and sure enough, the belt is securely fastened to the metal rod. You carefully lower yourself on the side of the train, gripping the metal rod for support. Suddenly, your foot hits a window sill. You continue to lower yourself into the window, until you are completely in the bathroom. So this is how the murderer entered the crime scene!

Bathroom
A cramped single toilet room with one toilet and one sink. Opposite of the door is an open window. The Passenger Car is South. At the center of the bathroom is a horrible sight: Felix's body is sprawled out on the floor. He is dead.

* * *

>e
Observation Car
A long room with glass windows on the walls. There are several couches facing the Glass Windows, so that people can watch the beautiful scenery fly by. On one of the couches is Luna's purse. The Passenger Car is west.

You can see Luna here.

>talk to luna
You can ask Luna about:

Herself.

The purpose of her journey.

What she was doing during the time of the crime.

The victim.

Anything suspicious. 

.

>ask about herself
You can't see any such thing.

>ask luna about herslef
There is no reply.

>ask luna about herself
"Come on, Alex. You've known me for years."

"Yes, but it's for the investigation."

"Ha ha, okay. I am the tailor's daughter. And, as you know, I born and raised in the village."

>ask luna about the purpose of her journey
"This morning when I heard that Felix was kidnapped, I immediately rushed to the Station to take a train to the City. I planned to find a legal consultant. If I could help the village, it would be through the law."

>ask luna about what she was doing during the time of the crime
"I was in the Observation Car enjoying the scenery."

>ask luna about felix
There is no reply.

>ask luna about the victim
"We... we were in a secret relationship before. I'm devastated that he's gone..."

>ask luna about anything suspicious
Luna thinks for a second, then says

"Yes. I saw that guy, Mark, rummaging through Felix's," her voice cracks, "-I mean the victim's things. You know what? Sorry. I want to be alone for a bit." Luna stands up and walks west to the Passenger Car, leaving her purse behind.

>x purse
A baby pink leather handbag.

>open purse
You open the purse and rummage around. Inside, she carries a bracelet and a silk belt.

>x bracelet
A homemade bracelet with a number of small soft pink jewels (probably fake) strung together. The string is knotted sloppily, with frays sticking out from the jewels.

>x silk belt
The belt is made of fine white silk, and is almost almost double your height. However, there is a bit of black powder on a small portion in the center. Creases on the dirtied portion suggested it was tied to something.

>x black powder
You can't see any such thing.

>take silk
You pull the Silk Belt out of the purse, and marvel at its length.

>i
You are carrying:
  Silk Belt
  Purple Notebook
  Purple Stone

>w
Passenger Car
There are about 30 open seats uniformly lined up across the room, but only a few are occupied. This should be where everybody sits during the majority of the journey.  As you walk through the isle, you see the belongings of a few people, including Mark's Backpack, Felix's Briefcase, and Sir Allan's Luggage.To the East is the Observation Car, and North is the Toilet.

You can see Luna, Mark and Audrey here.

>w
Train Entrance
A rather small room with little furnishing. The walls are made mostly of polished wood, and below you is a dark purple carpet. The Passenger Car is Eastward. 

You can see Black Suit and Sir Allan here.

>talk to black suit
Black Suit rests his head in his hands- it is obvious that he is in distress. You silently sit next to him, and he acknowledges you.

"He wasn't supposed to die," he sobs. "We were just supposed to escort him to the city, and release him when they gave up the stupid rocks. How am I going to face my family?"

"It's not alright that you've done this. But it wasn't your fault," you console. You realize that he genuinely cares about the situation, and is afraid of what will happen. He might not be at fault.

>talk to sir allan
 

You can ask Sir Allan about:

Himself.

The purpose of his journey.

What he was doing during the time of the crime.

The victim. 

His argument with the victim.

>ask sir allan about the purpose of his journey
"I'm returning to the city. I've just finished my retirement vacation."

>ask sir allan what he was doing during the time of the crime
I didn't understand that sentence.

>ask sir allan about what he was doing during the time of the crime
I was in the Train Entrance. You saw me!

>ask sir allan about the victim
he was friendly, and a nice boy who helped sir allan put his luggage onto the luggage rack.

>ask sir allan about his argument with the victim
sir allan is taken aback, but regains his composure quickly. he says that he suspected that felix stole a $50 bill from his luggage, and felix said he didn't.

>e
Passenger Car
There are about 30 open seats uniformly lined up across the room, but only a few are occupied. This should be where everybody sits during the majority of the journey.  As you walk through the isle, you see the belongings of a few people, including Mark's Backpack, Felix's Briefcase, and Sir Allan's Luggage.To the East is the Observation Car, and North is the Toilet.

You can see Luna, Mark and Audrey here.

>x backpack
A brown canvas zipper backpack. It is quite large, and occupies the whole seat.

* * *

>x photo
You can't see any such thing.

>x photograph
A small photo, presumably cut out from a yearbook, of a young boy. Clipped to the photograph is piece of paper, presumably a prescription, that reads "Peter Markson: Scarlet Fever. Prescription for antibiotics."

>take money
You shouldn't take it.

>take stacks of money
You can't see any such thing.

>ask mark about the money
There is no reply.

>talk to mark
 You can ask Mark about:

Himself.

The purpose of his journey.

What he was doing during the time of the crime.

The victim. 

 Him looking through victim's belongings.

 His son's medication.

>talk to audrey
You can ask Audrey about:

Herself.

The purpose of her journey.

What she was doing during the time of the crime.

The victim. 

2000 dollars in Mark's possession.

>ask audrey about the 2000 dollars in mark's possession
There is no reply.

>ask Audrey about 2000 dollars in mark's possession
Audrey's eyes widen at the mention of 2000 dollars.

"2000... that's the price of the medicine," she breathes. "Our son's medicine. Mark must've... Oh dear."

>talk to mark
 You can ask Mark about:

Himself.

The purpose of his journey.

What he was doing during the time of the crime.

The victim. 

 Him looking through victim's belongings.

 His son's medication.

>ask mark about him looking through victim's belongings
"I did not such thing!" He retorts. Perhaps we need to ask his wife, Audrey.

>talk to audrey
You can ask Audrey about:

Herself.

The purpose of her journey.

What she was doing during the time of the crime.

The victim. 

Her husband stealing.

2000 dollars in Mark's possession.

>ask audrey about her husband stealing
"No. My husband is a good man, he wouldn't do such a thing."

>open backpack
When you unzip it, you gasp. There are stacks of money crammed into the bag. You empty the contents on the chair and the` Dollar Bills drop out. When the back has been emptied, you notice a photograph among the bills.

>ask audrey about 2000 dollars in mark's possession
Audrey's eyes widen at the mention of 2000 dollars.

"2000... that's the price of the medicine," she breathes. "Our son's medicine. Mark must've... Oh dear."

>talk to mark
 You can ask Mark about:

Himself.

The purpose of his journey.

What he was doing during the time of the crime.

The victim. 

 Him stealing money from victim to pay for son's medication.

 His son's medication.

>ask mark about him stealing money from victim to pay for son's medication
You confront Mark, telling him that you know he stole the money to pay for his son's medicine.

"Okay, okay. I saw the money in the briefcase, and I just took it. My son is desperately sick, and I fear that once I pay for the medicine, I won't be able to feed my family."

>talk to mark
 You can ask Mark about:

Himself.

The purpose of his journey.

What he was doing during the time of the crime.

The victim. 

 His son's medication.

>talk to audrey
You can ask Audrey about:

Herself.

The purpose of her journey.

What she was doing during the time of the crime.

The victim. 

2000 dollars in Mark's possession.

>take 2000 dollars
You can't see any such thing.

>talk to luna
You can ask Luna about:

Herself.

The purpose of her journey.

What she was doing during the time of the crime.

The victim.

Anything suspicious. 

 Luna asked not to be disturbed. You shouldn't talk to her.

 Her silk belt.

>ask luna sbout her silk belt
I didn't understand that sentence.

>ask luna about her silk belt
"Oh!" She exclaims, "t-that. It was a ribbon on the back of my dress. I accidentally stepped on it, and it ripped off.

>i
You are carrying:
  Silk Belt
  Purple Notebook
  Purple Stone

>ask her about stain on belt
There is no reply.

>talk to luna
You can ask Luna about:

Herself.

The purpose of her journey.

What she was doing during the time of the crime.

The victim.

Anything suspicious. 

 Luna asked not to be disturbed. You shouldn't talk to her.

.

>read notebook
Flipping through it, you see only 4 pages have been written in. Start by reading page 1 of Purple Notebook.

>read page 1
What do you want to read page that in?

>read page 1 of purple notebook
You read: "We have discovered Charoite at one of the factory sites. Mining and selling the charoite would produce 940% profit."

>read page 2 of purple notebook
You read: "We approached the townspeople with one million dollars, hoping that they would take this meager sum in exchange for the precious stones. To our surprise, they refused with a passion. The local mayor shut down the factory and kicked us out. This does not do well."

>read page 3 of purple notebook
You read: "As the CEO, I have been advised to use more... cunning means to attain the charoite. They propose that we bait the mayor's son into our possession and use him to bargain. I have already communicated with the boy, and he has fallen for the trap. Soon, we will have the stones. The Company will certainly profit greatly."

>read page 4 of notebook
You read: "On the last page is a detailed drawing of a Cloud Stone. Calculations and notes about the stone are scribbled on the margins."

>talk to sir allan
You can only do that to something animate.

>talk sir allan
I didn't understand that sentence.

>w
Train Entrance
A rather small room with little furnishing. The walls are made mostly of polished wood, and below you is a dark purple carpet. The Passenger Car is Eastward. 

You can see Black Suit and Sir Allan here.

>talk to sir allan
 

You can ask Sir Allan about:

Himself.

The purpose of his journey.

What he was doing during the time of the crime.

The victim. 

 Being the CEO of the Company.

>ask sir allan of being the ceo of the company
I didn't understand that sentence.

>ask sir allan about being the ceo of the company
You angrily rush up to Sir Allan, demanding to know whether or not Sir Allan is really the CEO of the Company, which has plagued your home for years. "You! YOU'RE the CEO of the Company?" A look of surprise contorts Sir Allan's face, but he quickly regains his composure.

"No. I told you, I'm a retired old man returning to the city after a vacation."

"Would a retired old man have detailed reports of my hometown, that just so happen to be regarding a precious stone the Company seeks? Spit it out you old man."

"Well, I suppose you know now. There's really nothing else to say."

"Actually. There is. Did you kill Felix?" Sir Allan raises his brow in amusement.

"Now even if I did, I wouldn't tell you. But no, I did not kill Felix. I had no reason to. What would I gain from killing him? In fact, I would actually need the stupid boy alive to get the charoite. It wasn't us, I can tell you that. What happened was a tragedy, and now I have lost leverage on the Mayor. Damn it all."

>e
Passenger Car
There are about 30 open seats uniformly lined up across the room, but only a few are occupied. This should be where everybody sits during the majority of the journey.  As you walk through the isle, you see the belongings of a few people, including Mark's Backpack, Felix's Briefcase, and Sir Allan's Luggage.To the East is the Observation Car, and North is the Toilet.

You can see Luna, Mark and Audrey here.

>n
Bathroom
A cramped single toilet room with one toilet and one sink. Opposite of the door is an open window. The Passenger Car is South. At the center of the bathroom is a horrible sight: Felix's body is sprawled out on the floor. He is dead.

>e
You can't go that way.

>w
You can't go that way.

>s
Passenger Car
There are about 30 open seats uniformly lined up across the room, but only a few are occupied. This should be where everybody sits during the majority of the journey.  As you walk through the isle, you see the belongings of a few people, including Mark's Backpack, Felix's Briefcase, and Sir Allan's Luggage.To the East is the Observation Car, and North is the Toilet.

You can see Luna, Mark and Audrey here.

>e
Observation Car
A long room with glass windows on the walls. There are several couches facing the Glass Windows, so that people can watch the beautiful scenery fly by. On one of the couches is Luna's purse. The Passenger Car is west.

You can see Luna's Purse (in which is Bracelet) here.

>take bracelet
Taken.

>take purse
Taken.

>x windows
The clear glass windows replace the walls of the train. Light floods into the room, and the everything is tranquil. Through the windows, you watch the green countryside fly past. You push against the window, and it opens, surprising you. You stick your head out the window, wanting to feel the air, and see a ladder leading from the side of the train to the Roof. Perhaps you could climb up it.

>climb ladder
 You grip the cold metal handle and pull yourself up.

Roof
At the top of the train, you feel very unsafe. However, as you gaze at your surroundings, you are struck with admiration of the beautiful landscape. In front of you, there is a long stretch of white panels that is the roof. You notice that there is a metal rod running across the edges of each car.  You can go back down by climbing down the ladder.

>x metal rod
A long metal rod attached to the roof of the train. It appears to be extremely sooty... a bit of soot rubs off onto your when you touch it.

>x soot
You can't see any such thing.

>go down ladder
That's not something you can enter.

>climb down ladder
You grip the cold metal handle and step down.

Observation Car
A long room with glass windows on the walls. There are several couches facing the Glass Windows, so that people can watch the beautiful scenery fly by. On one of the couches is Luna's purse. The Passenger Car is west.

>w
Passenger Car
There are about 30 open seats uniformly lined up across the room, but only a few are occupied. This should be where everybody sits during the majority of the journey.  As you walk through the isle, you see the belongings of a few people, including Mark's Backpack, Felix's Briefcase, and Sir Allan's Luggage.To the East is the Observation Car, and North is the Toilet.

You can see Luna, Mark and Audrey here.

>talk to luna
You can ask Luna about:

Herself.

The purpose of her journey.

What she was doing during the time of the crime.

The victim.

Anything suspicious. 

 Luna asked not to be disturbed. You shouldn't talk to her.

.

>e
Observation Car
A long room with glass windows on the walls. There are several couches facing the Glass Windows, so that people can watch the beautiful scenery fly by. On one of the couches is Luna's purse. The Passenger Car is west.

>x windows
The clear glass windows replace the walls of the train. Light floods into the room, and the everything is tranquil. Through the windows, you watch the green countryside fly past. You push against the window, and it opens, surprising you. You stick your head out the window, wanting to feel the air, and see a ladder leading from the side of the train to the Roof. Perhaps you could climb up it.

* * *

>climb ladder
 You grip the cold metal handle and pull yourself up.

Roof
At the top of the train, you feel very unsafe. However, as you gaze at your surroundings, you are struck with admiration of the beautiful landscape. In front of you, there is a long stretch of white panels that is the roof. You notice that there is a metal rod running across the edges of each car.  You can go back down by climbing down the ladder.

>x panels
You can't see any such thing.

>x silk belt
The belt is made of fine white silk, and is almost almost double your height. However, there is a bit of black powder on a small portion in the center. Creases on the dirtied portion suggested it was tied to something.

>tie belt to rods
You can't see any such thing.

>tie belt to rod
You tie the silk belt securely on the metal rod. When you pull, you are surprised by the strength the belt.

This gives you an idea. What if the murderer used the Silk Belt as a rope? They could tie it to their waist and lower themselves into the bathroom!

>climb down belt
You can't see any such thing.

>tie belt to waist
 You wrap a portion of the belt around your waist. You should probably test the belt's security by pulling it.

* * *

>x jewel
A small pink Jewel, presumably from Luna's bracelet.

>take jewel
A small pink jewel. You realize that this jewel belongs to the bracelet in Luna's Purse. There is almost no doubt now, Luna is guilty.

Since the train is moving, you can safely ask Luna about her guilt. She has nowhere to run, she cannot escape.

* * *

>give note to kiosk
You can't see any such thing.

>give paper to guy
You firmly place the paper scrap onto the kiosk desk. The man looks up from his book, and takes it. He unfolds the paper, and the corner of his mouth tugs upward. He turns to the cash register, and takes out a wad of cash, carefully counting it before he hands it to you. He does not say a word, and returns to his book.

>give cash to conductor
(Conductor)
You hand the Conductor the wad of cash. He flips through, quickly counting it, and nods.

"Alright. You're good to go!" You cringe on the inside. This corruption is not unfamiliar to you, but to engage in it yourself... it's so wrong. "ALL ABOARD!" He yells, and steps South, into the Train.

I beg your pardon?

>n
Town Square
A square plaza with a cobblestone ground. Along the sides of the square are many two-story buildings. At the center of the square is a tall stone fountain, encircled by several wooden benches. Your cottage is to the West. East is the Mayor's House. There is a crowd gathered outside the Mayor's House.

>w
Cottage
A small one room compartment. Shoved into the corner of the room is your bed. Next to the door is your sorry excuse of a kitchen: a small stove, and a sink. At the center of the room is a squat wooden table. On the wall above your sink is a small one way window that looks into Town Square. You can go to Town Square by going East.

>w
You can't go that way.

* * *

>e
Town Square
A square plaza with a cobblestone ground. Along the sides of the square are many two-story buildings. At the center of the square is a tall stone fountain, encircled by several wooden benches. Your cottage is to the West. East is the Mayor's House. There is a crowd gathered outside the Mayor's House.

>es
That's not a verb I recognise.

>s
Station
The Station is slow and idle. The town is not an attraction, and the Station is merely a stop for business men who need work in the city, or visit home. You see only a few business men walking around, luggages in tow. Prominently in the center of the station is a large faded red ticket booth. Next to it is a small kiosk, selling beverages and food items. To the south is the Train, waiting to depart.

>s
the Sliding Door slides shut just as you leap into the Train Entrance car. You hear the train whir to life. Suddenly, you feel yourself stumble backwards, and find that outside, the scenery begins flying past. You hear the Conductor's voice again: "Hello everybody. We are now headed to the City. Relax, and enjoy your time during this journey."

Train Entrance
A rather small room with little furnishing. The walls are made mostly of polished wood, and below you is a dark purple carpet. The Passenger Car is Eastward. 

You can see Sir Allan here.

* * *

>e
Passenger Car
There are about 30 open seats uniformly lined up across the room, but only a few are occupied. This should be where everybody sits during the majority of the journey. To the East is the Observation Car, and North is the Toilet.

You can see Mark and Audrey here.

>e
Observation Car
A long room with glass windows on the walls. There are several couches facing the Glass Windows, so that people can watch the beautiful scenery fly by.  The Passenger Car is west.

You can see Black Suit and Luna here.

>ask luna about anything suspicious
Luna thinks for a second, then says

"Yes. I saw that guy, Mark, rummaging through Felix's," her voice cracks, "-I mean the victim's things. You know what? Sorry. I need to take a walk." Luna stands up and walks west to the Passenger Car, leaving her purse behind.

>open purse
You open the purse and rummage around. Inside, she carries a bracelet and a silk belt.

* * *

>take silk belt
You pull the Silk Belt out of the purse, and marvel at its length.

>climb ladder
 You grip the cold metal handle and pull yourself up.

Roof
At the top of the train, you feel very unsafe. However, as you gaze at your surroundings, you are struck with admiration of the beautiful landscape. In front of you, there is a long stretch of white panels that is the roof. You notice that there is a metal rod running across the edges of each car.  You can go back down by climbing down the ladder.

>pull belt
You give the belt a tug, and sure enough, the belt is securely fastened to the metal rod. You carefully lower yourself on the side of the train, gripping the metal rod for support. Suddenly, your foot hits a window sill. You continue to lower yourself into the window, until you are completely in the bathroom. So this is how the murderer entered the crime scene!

Bathroom
A cramped single toilet room with one toilet and a sink. Opposite of the door is an open window. The Passenger Car is South. At the center of the bathroom is a horrible sight: Felix's body is sprawled out on the floor. He is dead.  Out of the corner of your eye, you notice a small glimmer in Felix's palm. You carefully unclench Felix's palm and discover that it is a small jewel.

>x jewel
A small pink Jewel, presumably from Luna's bracelet.

>l
Bathroom
A cramped single toilet room with one toilet and a sink. Opposite of the door is an open window. The Passenger Car is South. At the center of the bathroom is a horrible sight: Felix's body is sprawled out on the floor. He is dead.  Out of the corner of your eye, you notice a small glimmer in Felix's palm. You carefully unclench Felix's palm and discover that it is a small jewel.

>w
You can't go that way.

>n
You can't go that way.

>s
Passenger Car
There are about 30 open seats uniformly lined up across the room, but only a few are occupied. This should be where everybody sits during the majority of the journey. To the East is the Observation Car, and North is the Toilet.

You can see Luna, Mark and Audrey here.

>x backpack
A brown canvas zipper backpack. It is quite large, and occupies the whole seat.

>open backpack
You shouldn't touch other people's things unless you have a good reason to.

>take backpack
 You take the backpack, which is surprisingly heavy.

* * *

>e
Wait. You still have to take your Cloud Stone, it should be on the table.

>take stone
Taken.

* * *

>s
You can't go that way.

* * *

>w
You can't go that way.

>e
You can't go that way.

>n
You can't go that way.

>talk to mayor
"Mayor, I think we need to hurry." The Mayor closes his eyes.

"Yes," he murmurs, "We should. Alex, I need you to chase my son. I am well past my prime, and cannot leave the villagers. Heaven only knows what they would do if I walked away from the town. Please go to the Station and save my son." You nod dutifully, and walk to the exit.

Station
The Station is slow and idle. The town is not an attraction, and the Station is merely a stop for business men who need work in the city, or visit home. You see only a few business men walking around, luggages in tow. Prominently in the center of the station is a large faded red ticket booth. Next to it is a small kiosk, selling beverages and food items. To the south is the Train, waiting to depart.  Leaning against one of the pillars is a tall lanky boy, who you recognize instantly: Felix. Next to him is a man in a black suit, who Felix merrily jokes with. What in the world?

You can see Black Suit and Felix here.

>w
You can't go that way.

>ne
You can't go that way.

* * *

>w
You can't go that way.

* * *

>e
Town Square
A square plaza with a cobblestone ground. Along the sides of the square are many two-story buildings. At the center of the square is a tall stone fountain, encircled by several wooden benches. Your cottage is to the West. East is the Mayor's House. There is a crowd gathered outside the Mayor's House.

>get on bench
You get onto Benches.

After stepping onto the bench, you take a look over the crowd. What you see does not surprise you. A young man in a black suit stands proudly at the center of the crowd, a smirk corrupting his handsome face. This man is Edgar, a representative of the Company. Next to him, the Mayor angrily faces him. He looks like he wants to punch Edgar right then and there, but is holding back for some reason.

>talk to man
You can't see any such thing.

>talk to mayor
You push and squeeze through the crowd of angry villagers until you come to the Mayor. He does not even notice you until you shake him roughly on the shoulder. You have to shout for him to hear you, "Sir, what is happening?"

"Him," he points to Edgar. "He just informed us that the Company has Felix."

You are taken aback. They have Felix?

"Your son, Felix?"

"Who else?!" The mayor cries angrily. "They want the damn rocks! Now they've resorted to this trickery and blackmailing. What villains!"

"What can we do?" You ask earnestly.

"I don't know," he says as he shakes his head, "Why don't we go into the house to speak."

"Alright." The mayor turns to Edgar and says in his booming voice,

"Enough!" The crowd goes silent. "Edgar. We will give you an answer soon. In the meantime, at least tell me where my son is."

Edgar laughs. "Now? Probably on the way to the City. I will await your reply," he cackles as he walks away. The mob of villagers glare at Edgar, as he arrogantly strides away. When he is out of sight, the villagers begin to head back to their homes, grumbling to themselves.

You turn to the Mayor and he unlocks the door to his house. You follow him into the spacious mansion.

Mayor's House
When you walk into the house, you are stunned by the beautiful furnishing that seems to glitter in the house. At the center of the pearly marble white floor is a large glossy wooden dining table, on top of which is an elegant flower arrangement. Under a magnificent acrylic painting is a polished large leather sofa. The Mayor plops down on the sofa and deflates.

>talk to mayor
"Mayor, I think we need to hurry." The Mayor closes his eyes.

"Yes," he murmurs, "We should. Alex, I need you to chase my son. I am well past my prime, and cannot leave the villagers. Our Lady only knows what they would do if I walked away from the town. Please go to the Station and save my son." You nod dutifully, and walk to the exit.

Station
The Station is slow and idle. The town is not an attraction, and the Station is merely a stop for business men who need work in the city, or visit home. You see only a few business men walking around, luggages in tow. Prominently in the center of the station is a large faded red ticket booth. Next to it is a small kiosk, selling beverages and food items. To the south is the Train, waiting to depart.  Leaning against one of the pillars is a tall lanky boy, who you recognize instantly: Felix. Next to him is a man in a black suit, who Felix merrily jokes with. What in the world?

>talk to felix
You stride towards Felix, and slap him across the face. He is dumbfounded for a moment before registering who you are. He gestures apologetically to the the men in suits and they walk away.

"You ignorant boy. What are you doing?" You shout at him.

"I'm going to the city, Alex," he retorts. "I'm sick of that stupid village. I don't want to inherit the position of mayor when I have the potential to do so much more. Luckily, the Company realized this and offered to relocate me. They're bringing me to the city, it's going to be wonderful!"

"You don't understand. Right now the Company has told your father that they are holding you in their custody. They said that if the villagers don't yield the Lady's Flower, they'll harm you."

"Don't joke with me. That old fart's probably willing to say anything to get me back to the village. And once they do, they'll never let me leave again."

"You shut up! If the villagers do end up handing over the stones, they'll catch up and toss you back into the village. Please Felix, come to your sense."

"No! I can't stay there. Even if your story is true, the villagers would never hand over the stupid rocks. They have too much prided for that!" The speakers in the Station suddenly blare out:

"Train 342 to the City is departing in 5 minutes-please board now. Thank you." Felix looks at you, then shoves you out of the way to gather his belongings.

>go to train
You can't see any such thing.

>s
You walk up to the Train Conductor, an elderly man with a sneer on his face. You say,

"Ah. Hello. I need to get on the train."

"Do you have a ticket?" He asks. You shake your head.

"Do you have anything else that can get you on the train?" He opens his palm towards you, facing upwards.

>i
You are carrying nothing.

>high five hand
That's not a verb I recognise.

>l
Station
The Station is slow and idle. The town is not an attraction, and the Station is merely a stop for business men who need work in the city, or visit home. You see only a few business men walking around, luggages in tow. Prominently in the center of the station is a large faded red ticket booth. Next to it is a small kiosk, selling beverages and food items. To the south is the Train, waiting to depart.  Leaning against one of the pillars is a tall lanky boy, who you recognize instantly: Felix. Next to him is a man in a black suit, who Felix merrily jokes with. What in the world?

>go to ticked booth
You can't see any such thing.

>x ticket booth
A squat boxy room standing in the middle of the station. The ticket booth is old, its bright red color faded from years of neglect. On its faded walls are years of expired promotion posters, graffiti, and dried gum. Its windows are dirty and unclean, but a clean piece of paper is pasted on the glass-a train table. Behind the counter sits a bored woman. On closer inspection, you realize that the woman is a villager named Rita.

>talk to woman
You can't see any such thing.

>talk to rita
You walk up to the counter, and say,

"Hi Ms. Rita. Long time no see, how have you been?" Her eyes focus, and she smiles grimly.

"Hello Marian,"

"Marcus", you correct.

"Marcus. You know, same old same old. How's ya mother? She good?" You nod.

"Yep. Uh, listen Rita. I need a ticket onto that train over there. How much does it cost?"

"Sorry, boy. Tickets are all sold out. Budget cuts, ya know? They're limiting passengers to lighten the load." You raise your brow. Budget cuts?

"This is really important. The Company's done something real bad this time."

"The Company?" Rita's eyes bulge, "Oh dear. Uh... Oh! You see the Conductor over there? Sometimes he allows some extra people onto the train in exchange for something in return. Ya know what I mean?"

"How much?"

"$20 dollahs."

"20!? That's daylight robbery!" She grabs a piece of scrap paper from her cluttered desk and scrawls something on it.

"Here," she says as she hands it to you. "Give it to the kiosk guy. He owes me."

>x kiosk
(Kiosk)
A small kiosk, selling beverages and food items.

>talk to guy
You approach the Kiosk Guy, who is intently reading his book. You say, "Uh. Hello. Can you help me?"

He immediately looks up. The glare in his face startles you, and you back away.

>i
You are carrying:
  Paper Scrap

>give guy paper
You firmly place the paper scrap onto the kiosk desk. The man looks up from his book, and takes it. He unfolds the paper, and the corner of his mouth tugs upward. He turns to the cash register, and takes out a wad of cash, carefully counting it before he hands it to you. He does not say a word, and returns to his book.

>i
You are carrying:
  Wad of Cash

>l
Station
The Station is slow and idle. The town is not an attraction, and the Station is merely a stop for business men who need work in the city, or visit home. You see only a few business men walking around, luggages in tow. Prominently in the center of the station is a large faded red ticket booth. Next to it is a small kiosk, selling beverages and food items. To the south is the Train, waiting to depart.  Leaning against one of the pillars is a tall lanky boy, who you recognize instantly: Felix. Next to him is a man in a black suit, who Felix merrily jokes with. What in the world?

>s
You walk up to the Train Conductor, an elderly man with a sneer on his face. You say,

"Ah. Hello. I need to get on the train."

"Do you have a ticket?" He asks. You shake your head.

"Do you have anything else that can get you on the train?" He opens his palm towards you, facing upwards.

>l
Station
The Station is slow and idle. The town is not an attraction, and the Station is merely a stop for business men who need work in the city, or visit home. You see only a few business men walking around, luggages in tow. Prominently in the center of the station is a large faded red ticket booth. Next to it is a small kiosk, selling beverages and food items. To the south is the Train, waiting to depart.  Leaning against one of the pillars is a tall lanky boy, who you recognize instantly: Felix. Next to him is a man in a black suit, who Felix merrily jokes with. What in the world?

>n
Town Square
A square plaza with a cobblestone ground. Along the sides of the square are many two-story buildings. At the center of the square is a tall stone fountain, encircled by several wooden benches. Your cottage is to the West. East is the Mayor's House. There is a crowd gathered outside the Mayor's House.

>s
Station
The Station is slow and idle. The town is not an attraction, and the Station is merely a stop for business men who need work in the city, or visit home. You see only a few business men walking around, luggages in tow. Prominently in the center of the station is a large faded red ticket booth. Next to it is a small kiosk, selling beverages and food items. To the south is the Train, waiting to depart.  Leaning against one of the pillars is a tall lanky boy, who you recognize instantly: Felix. Next to him is a man in a black suit, who Felix merrily jokes with. What in the world?

>s
You walk up to the Train Conductor, an elderly man with a sneer on his face. You say,

"Ah. Hello. I need to get on the train."

"Do you have a ticket?" He asks. You shake your head.

"Do you have anything else that can get you on the train?" He opens his palm towards you, facing upwards.

>give conductor wad of cash
(Conductor Wad of Cash)
You hand the Conductor the wad of cash. He flips through, quickly counting it, and nods.

"Alrighty. You're good to go!" You cringe on the inside. This corruption is not unfamiliar to you, but to engage in it yourself... that's wrong. "ALL ABOARD!" He yells. And steps inside the Train.

I beg your pardon?

I beg your pardon?

>w
You can't go that way.

* * *

>e
You can't go that way.

>l
Station
The Station is slow and idle. The town is not an attraction, and the Station is merely a stop for business men who need work in the city, or visit home. You see only a few business men walking around, luggages in tow. Prominently in the center of the station is a large faded red ticket booth. Next to it is a small kiosk, selling beverages and food items. To the south is the Train, waiting to depart.

>e
You can't go that way.

>s
the Sliding Door slid shut just as you leap into the Train Entrance car. You hear the train whir to life. Suddenly, you feel yourself stumble backwards, and find that outside, the scenery begins flying past. You hear the Conductor's voice again: "Hello everybody. We are now headed to the City. Relax, and enjoy your time during this journey."

Train Entrance
A rather small room with little furnishing. The walls of the Entrance room are mostly glass windows.  

You can see Sir Allan here.

>s
You can't go that way.

>s
You can't go that way.

>talk to sir allan
 You politely wave at Sir Allan, and he waves back. He approaches you inquires,

"Might you be a local here?" You nod. "Interesting. I've just come from the countryside after a wonderful vacation there, at my villa. I was born there, you know, in the spring of 1942. Back then, we were in the midst of the War. My father went to fight, and he never came back," you nod as Sir Allan elaborates his life story to you. He beams as he talks about his rise to wealth from poverty. You zone out, and eventually Sir Allan stops talking. 

You politely wave at Sir Allan, and he waves back.

>1
That's not a verb I recognise.

I beg your pardon?

>2
That's not a verb I recognise.

>3
That's not a verb I recognise.

I beg your pardon?

>l
Train Entrance
A rather small room with little furnishing. The walls of the Entrance room are mostly glass windows.  

You can see Sir Allan here.

>talk to sir allan
 You politely wave at Sir Allan, and he waves back. He approaches you inquires,

"Might you be a local here?" You nod. "Interesting. I've just come from the countryside after a wonderful vacation there, at my villa. I was born there, you know, in the spring of 1942. Back then, we were in the midst of the War. My father went to fight, and he never came back," you nod as Sir Allan elaborates his life story to you. He beams as he talks about his rise to wealth from poverty. You zone out, and eventually Sir Allan stops talking. 

You politely wave at Sir Allan, and he waves back.

>wave
You wave.

>wave at sir allan
You can't see any such thing.

>l
Train Entrance
A rather small room with little furnishing. The walls of the Entrance room are mostly glass windows.  

You can see Sir Allan here.

>x
(Wad of Cash)
You see nothing special about Wad of Cash.

>e
Passenger Car
The room is longer than it is wide. There are about 30 open seats, but only a few are occupied. Along the walls are large glass windows. To the East is the Observation Car.

You can see Mark and Audrey here.

>talk to mark
He is sleeping in one of the seats. You probably shouldn't disturb him.

>wake mark
That seems unnecessary.

>please
That's not a verb I recognise.

>talk to audrey
Audrey paces by the bathroom, as if she really needs to go. She grumbles that the person inside has been in there for over an hour. You talk to her, and she gives you a small smile,

"I would talk to you, but my bladder is quite uncomfortable right now."

>n
The door is locked shut. You politely knock once. After a long minute of silence, you knock again. This time, you yell, "Is anybody there?!" Silence. You push the door with a bit of force.

"What in the world?" You slam your body against the door. You hear a slight crack.

You push again, and the lock breaks with a resounding clap. The door swings open and reveals the bathroom.

>n
Bathroom
A cramped single toilet room with one toilet and one sink.  At the center of the bathroom is a horrible sight: Felix's body is sprawled out on the floor. He is dead.  

You can see Corpse here.

>take corpse
I don't suppose Corpse would care for that.

>x corpse
He has just recently died. His eyes are wide open, and his mouth hangs open. You notice there are red marks around Felix's neck. Perhaps Felix died from strangulation?

>commence CPR
That's not a verb I recognise.

>exit
But you aren't in anything at the moment.

>i
You are carrying:
  Murder
  Wad of Cash

>s
Passenger Car
The room is longer than it is wide. There are about 30 open seats, but only a few are occupied. Along the walls are large glass windows. To the East is the Observation Car.

You can see Mark and Audrey here.

>give murder to mark
Mark doesn't seem interested.

>murder mark
Violence isn't the answer to this one.

>talk to mark
 You can ask Mark about:

Himself.

The purpose of his journey.

What he was doing and where during the time of the crime.

The victim.

>4
That's not a verb I recognise.

>the victim
That's not a verb I recognise.

>ask mark about victim
There is no reply.

>ask mark about the victim
he saw the victim arguing with sir allan

>ask mark about the purpose of his journey
going to city for son's medicine.

>ask mark about himself
worried. will the mystery keep the people on the train after they arrive?

>ask mark about What he was doing and where during the time of the crime
taking a nap in his private room.

>s
You can't go that way.

>n
Bathroom
A cramped single toilet room with one toilet and one sink.  At the center of the bathroom is a horrible sight: Felix's body is sprawled out on the floor. He is dead.  

You can see Corpse here.

>n
You can't go that way.

>s
Passenger Car
The room is longer than it is wide. There are about 30 open seats, but only a few are occupied. Along the walls are large glass windows. To the East is the Observation Car.

You can see Mark and Audrey here.

>n
Bathroom
A cramped single toilet room with one toilet and one sink.  At the center of the bathroom is a horrible sight: Felix's body is sprawled out on the floor. He is dead.  

You can see Corpse here.

>s
Passenger Car
The room is longer than it is wide. There are about 30 open seats, but only a few are occupied. Along the walls are large glass windows. To the East is the Observation Car.

You can see Mark and Audrey here.

>e
Observation Car
A long with glass window on the walls and ceiling. There are several couches facing the windows, so that people can watch the beautiful scenery fly by. On one of the couches is Luna's purse, which is placed on top of a Novel..

You can see Luna here.

>w
Passenger Car
The room is longer than it is wide. There are about 30 open seats, but only a few are occupied. Along the walls are large glass windows. To the East is the Observation Car.

You can see Mark and Audrey here.

>w
Train Entrance
A rather small room with little furnishing. The walls of the Entrance room are mostly glass windows.  

You can see Sir Allan here.

>e
Passenger Car
The room is longer than it is wide. There are about 30 open seats, but only a few are occupied. Along the walls are large glass windows. To the East is the Observation Car.

You can see Mark and Audrey here.

>w
Train Entrance
A rather small room with little furnishing. The walls of the Entrance room are mostly glass windows.  

You can see Sir Allan here.

>n
You can't go that way.

>w
You can't go that way.

>s
You can't go that way.

>e
Passenger Car
The room is longer than it is wide. There are about 30 open seats, but only a few are occupied. Along the walls are large glass windows. To the East is the Observation Car.

You can see Mark and Audrey here.

>e
Observation Car
A long with glass window on the walls and ceiling. There are several couches facing the windows, so that people can watch the beautiful scenery fly by. On one of the couches is Luna's purse, which is placed on top of a Novel..

You can see Luna here.

>talk to luna
You can ask Luna about:

Herself.

The purpose of her journey.

What she was doing and where when the crime happened.

The victim.

Anything suspicious. 

.

>ask about Anything suspicious.
You can't see any such thing.

>ask luna
What do you want to ask Luna for?

>Anything suspicious
You can't see any such thing.

>ask luna about anything suspicious
she saw mark looking through victim's belongings. After talking, Luna puts her purse down and excuses herself because she needs some time alone to think about what's happened.

>talk to luna
You can't see any such thing.

>w
Passenger Car
The room is longer than it is wide. There are about 30 open seats, but only a few are occupied. Along the walls are large glass windows. To the East is the Observation Car.

You can see Luna, Mark and Audrey here.

>talk to luna
You can ask Luna about:

Herself.

The purpose of her journey.

What she was doing and where when the crime happened.

The victim.

Anything suspicious. 

.

>ask luna about the victim
she and the victim were very close, but had to keep their relationship secret.

>ask luna about herself
she betrays some shivers, but her face remains steady. she comes from the village, and is the tailor's daughter.

>ask luna about What she was doing and where when the crime happened
reading a book in her seat.

>ask luna about the purpose of her journey
going to city to hire a legal consultant to fight the Company.

>i
You are carrying:
  LunaInformation 1
  MarkInformation 1
  MarkInformation 4
  SirAllanInformation 1
  Murder
  Wad of Cash

>x murder
You see nothing special about Murder.

>x wad of cash
You see nothing special about Wad of Cash.

>x   MarkInformation 4
Mark's son is sick.

>x MarkInformation  1
Mark was seen rummaging through the victim's belongings.

>x   LunaInformation 1
Luna and the victim had some kind of relationship back in the village.

>x   SirAllanInformation 1
Sir Allan was arguing with the victim.

>s
You can't go that way.

>w
Train Entrance
A rather small room with little furnishing. The walls of the Entrance room are mostly glass windows.  

You can see Sir Allan here.

>talk to sir allan
 

You can ask Sir Allan about:

Himself.

The purpose of his journey.

What he was doing and where during the time of the crime.

The victim. 

His argument with the victim.

>ask Sir Allan about the victim
he was friendly, and a nice boy who helped sir allan put his luggage onto the luggage rack.

>i
You are carrying:
  LunaInformation 1
  MarkInformation 1
  MarkInformation 4
  SirAllanInformation 1
  Murder
  Wad of Cash

>ask sirallan about
You can't see any such thing.

>His argument with the victim
That's not a verb I recognise.

>His argument with the victim
That's not a verb I recognise.

>ask sir allan about His argument with the victim
sir allan is taken aback, but regains his composure quickly. he says that he suspected that felix stole a $50 dollar bill from his luggage, and felix said he didn't.

>w
You can't go that way.

>e
Passenger Car
The room is longer than it is wide. There are about 30 open seats, but only a few are occupied. Along the walls are large glass windows. To the East is the Observation Car.

You can see Luna, Mark and Audrey here.

>talk to mark
 You can ask Mark about:

Himself.

The purpose of his journey.

What he was doing and where during the time of the crime.

The victim. 

 Him looking through victim's belongings.

 His son's medication.

>ask mark about his son's medication
There is no reply.

>ask mark about  Him looking through victim's belongings
he says he did no such thing.

>ii
That's not a verb I recognise.

>i
You are carrying:
  MarkInformation 2
  SirAllanInformation 2
  LunaInformation 1
  MarkInformation 4
  Murder
  Wad of Cash

>x sirallan informaiton
You can't see any such thing.

>x sirallan information
You can't see any such thing.

>x sirallan information 2
You can't see any such thing.

>x  SirAllanInformation 2
Sir Allan was arguing with the victim>The victim supposedly stole $50 dollars from Sir Allan.

>w
Train Entrance
A rather small room with little furnishing. The walls of the Entrance room are mostly glass windows.  

You can see Sir Allan here.

>e
Passenger Car
The room is longer than it is wide. There are about 30 open seats, but only a few are occupied. Along the walls are large glass windows. To the East is the Observation Car.

You can see Luna, Mark and Audrey here.

>e
Observation Car
A long with glass window on the walls and ceiling. There are several couches facing the windows, so that people can watch the beautiful scenery fly by. On one of the couches is Luna's purse, which is placed on top of a Novel..

You can see Luna's Purse (closed) here.

>w
Passenger Car
The room is longer than it is wide. There are about 30 open seats, but only a few are occupied. Along the walls are large glass windows. To the East is the Observation Car.

You can see Luna, Mark and Audrey here.

>ask luna
What do you want to ask Luna for?

>money
You can't see any such thing.

>ask mark for money
You can't see any such thing.

>i
You are carrying:
  MarkInformation 2
  SirAllanInformation 2
  LunaInformation 1
  MarkInformation 4
  Murder
  Wad of Cash

>x windows
You can't see any such thing.

>talk to audrey
You can ask Audrey about:

Herself.

The purpose of her journey.

What she was doing and where when the crime happened.

The victim. 

Her husband stealing.

>ask audrey about her husband stealing
she knows nothing about it, and says that her husband is a good family man.

>i
You are carrying:
  AudreyInformation 2
  MarkInformation 2
  SirAllanInformation 2
  LunaInformation 1
  MarkInformation 4
  Murder
  Wad of Cash

>x belongings
You can't see any such thing.

>x felix breifcase
You can't see any such thing.

>x briefcase
The large briefcase that Felix was holding in the Station. It is made of a luxurious brown leather, and engraved with the marking of some designer based in the city.

>open briefcase
You open Felix's Briefcase, revealing Felix's Money.

>take money
You can't take it out.

>x money
You are amazed the the sheer number of $100 bills loaded into the Briefcase. Felix must have stolen all of this from the Mayor. It would only be right to return it. You feel your face boil from anger. The audacity of Felix to take this.

>take money
You can't take it out.

>take briefcase
Taken.

>burn money
This dangerous act would achieve little.

>burn mark
This dangerous act would achieve little.

>kill mark
Violence isn't the answer to this one.

>why not
That's not a verb I recognise.

>l
Passenger Car
The room is longer than it is wide. There are about 30 open seats, but only a few are occupied. Along the walls are large glass windows. To the East is the Observation Car.

You can see Luna, Mark and Audrey here.

>ask mark
What do you want to ask Mark for?