You wake up to shouts and loud banging. It is early; the sun has just begun to rise. After groggily getting out from bed, you peer out the window. There is a crowd of people gathered outside in front of the Mayor's House.  It's too early! What is happening?

Mercenaries
An Interactive Fiction by Elana Shi
Release 1 / Serial number 141024 / Inform 7 build 6L38 (I6/v6.33 lib 6/12N) SD

Cottage
A small one room compartment. Shoved into the corner of the room is your bed. Next to the door is your sorry excuse of a kitchen: a small stove, and a sink. At the center of the room is a squat wooden table with the stone on it. On the wall above your sink is a small one way window that looks into Town Square. You can go to Town Square by going East.

>w
You can't go that way.

* * *

>e
Wait. You still have to take your Lady's Flower, it should be on the table.

>n
You can't go that way.

>e
You pull the on the brass handle, but the door appears to unlocked. Plus, it's not your home-you shouldn't go in without permission.

>stand on bench
You get onto Benches.

After stepping onto the bench, you take a look over the crowd. What you see does not surprise you. A young man in a black suit stands proudly at the center of the crowd, a smirk corrupting his handsome face. This man is Edgar, a representative of the Company. Next to him, the Mayor angrily faces him. He looks like he wants to punch Edgar right then and there, but is holding back for some reason.

>e
You pull the on the brass handle, but the door appears to unlocked. Plus, it's not your home-you shouldn't go in without permission.

* * *

>e
Wait. You still have to take your Lady's Flower, it should be on the table.

>x ground
Medium sized rocks lay in a circular pattern around the fountain.

* * *

>x buildings
Two-story buildings line the side of the square. These buildings contain homes, stores, and restaurants. The stores and restaurants are all closed, but dim lights illuminate from the windows.

>x fountain
The sculpture makes as a humble fountain, but radiates an aura of tranquility. The smooth stone features a woman carrying a flower in one hand and a rock in the other. This is probably the woman in the Lady's Flower.

>x benches
Plain wooden benches meant for decoration. Years ago when you were a small child, you would stand on these benches and haughtily beamed over your friend's heads. You were the king of the world!

>x cottage
You can't see any such thing.

>x windows
You can't see any such thing.

>x crowd
The crowd consists of angry village women and men. They hold pitchforks and shovel; you cannot see what's happening as they are too tall.

>stand on bench
You get onto Benches.

After stepping onto the bench, you take a look over the crowd. What you see does not surprise you. A young man in a black suit stands proudly at the center of the crowd, a smirk corrupting his handsome face. This man is Edgar, a representative of the Company. Next to him, the Mayor angrily faces him. He looks like he wants to punch Edgar right then and there, but is holding back for some reason.

>get off bench
You get off Benches.

Town Square
A square plaza with a cobblestone ground. Along the sides of the square are many two-story buildings. At the center of the square is a tall stone fountain, encircled by several wooden benches. Your cottage is to the West. East is the Mayor's House. There is a crowd gathered outside the Mayor's House.

>stand on bench
You get onto Benches.

After stepping onto the bench, you take a look over the crowd. What you see does not surprise you. A young man in a black suit stands proudly at the center of the crowd, a smirk corrupting his handsome face. This man is Edgar, a representative of the Company. Next to him, the Mayor angrily faces him. He looks like he wants to punch Edgar right then and there, but is holding back for some reason.

>talk to edgar
You yell out at Edgar, but your voice is lost in the shouts of the other villagers.

>talk to mayor
You push and squeeze through the crowd of angry villagers until you come to the Mayor. He does not even notice you until you shake him roughly on the shoulder. You have to shout for him to hear you, "Sir, what is happening?"

"Him," he points to Edgar. "He just informed us that the Company has Felix."

You are taken aback. They have Felix?

"Your son, Felix?"

"Who else?!" The mayor cries angrily. "They want the damn rocks! Now they've resorted to this trickery and blackmailing. What villains!"

"What can we do?" You ask earnestly.

"I don't know," he says as he shakes his head, "Why don't we go into the house to speak."

"Alright." The mayor turns to Edgar and says in his booming voice,

"Enough!" The crowd goes silent. "Edgar. We will give you an answer soon. In the meantime, at least tell me where my son is."

Edgar laughs. "Now? Probably on the way to the City. I will await your reply," he cackles as he walks away. The mob of villagers glare at Edgar, as he arrogantly strides away. When he is out of sight, the villagers begin to head back to their homes, grumbling to themselves.

You turn to the Mayor and he unlocks the door to his house. You follow him into the spacious mansion.

Mayor's House
When you walk into the house, you are stunned by the beautiful furnishing that seems to glitter in the house. At the center of the pearly marble white floor is a large glossy wooden dining table, on top of which is an elegant flower arrangement. Under a magnificent acrylic painting is a polished large leather sofa. The Mayor plops down on the sofa and deflates.

>x floor
Floor.

>x table
Table.

>x flower
Flower Arrangement.

>talk to mayor
"Mayor, I think we need to hurry." The Mayor closes his eyes.

"Yes," he murmurs, "We should. Alex, I need you to chase my son. I am well past my prime, and cannot leave the villagers. Our Lady only knows what they would do if I walked away from the town. Please go to the Station and save my son." You nod dutifully, and walk to the exit.

Station
The Station is slow and idle. The town is not an attraction, and the Station is merely a stop for business men who need work in the city, or visit home. You see only a few business men walking around, luggages in tow. Prominently in the center of the station is a large faded red ticket booth. Next to it is a small kiosk, selling beverages and food items. To the south is the Train, waiting to depart.  Leaning against one of the pillars is a tall lanky boy, who you recognize instantly: Felix. Next to him is a man in a black suit, who Felix merrily jokes with. What in the world?

You can see Black Suit here.

>s
You walk up to the Train Conductor, an elderly man with a sneer on his face. You say,

"Ah. Hello. I need to get on the train."

"Do you have a ticket?" He asks. You shake your head.

"Do you have anything else that can get you on the train?" He opens his palm towards you, facing upwards.

>undo
Station
[Previous turn undone.]

>x people
You can't see any such thing.

>x business men
Business men.

>x kiosk
(Kiosk)
A small kiosk, selling beverages and food items.

>x ticket booth
A squat boxy room standing in the middle of the station. The ticket booth is old, its bright red color faded from years of neglect. On its faded walls are years of expired promotion posters, graffiti, and dried gum. Its windows are dirty and unclean, but a clean piece of paper is pasted on the glass-a train table. Behind the counter sits a bored woman. On closer inspection, you realize that the woman is a villager named Rita.

>speak to rita
You walk up to the counter, and say,

"Hi Ms. Rita. Long time no see, how have you been?" Her eyes focus, and she smiles grimly.

"Hello Marian,"

"Marcus", you correct.

"Marcus. You know, same old same old. How's ya mother? She good?" You nod.

"Yep. Uh, listen Rita. I need a ticket onto that train over there. How much does it cost?"

"Sorry, boy. Tickets are all sold out. Budget cuts, ya know? They're limiting passengers to lighten the load." You raise your brow. Budget cuts?

"This is really important. The Company's done something real bad this time."

"The Company?" Rita's eyes bulge, "Oh dear. Uh... Oh! You see the Conductor over there? Sometimes he allows some extra people onto the train in exchange for something in return. Ya know what I mean?"

"How much?"

"$20 dollahs."

"20!? That's daylight robbery!" She grabs a piece of scrap paper from her cluttered desk and scrawls something on it.

"Here," she says as she hands it to you. "Give it to the kiosk guy. He owes me."

>x kiosk guy
Kiosk Guy.

>x feli
You can't see any such thing.

>x felix
A tall boy, who just turned 18 in the fall. He cooly leans against the a concrete pillar, an aura of youthful arrogance and hopefulness surrounds him. His hair is cropped closely to his narrow face and evenly combed. Freckles are splattered over his nose, and his mouth naturally curves up into a faint smile. He is dressed smartly in a light grey suit, with a black tie. He hugs a rather large briefcase, pulling it tightly towards his chest.

>give paper to kiosk guy
You firmly place the paper scrap onto the kiosk desk. The man looks up from his book, and takes it. He unfolds the paper, and the corner of his mouth tugs upward. He turns to the cash register, and takes out a wad of cash, carefully counting it before he hands it to you. He does not say a word, and returns to his book.

>take good
You can't see any such thing.

>i
You are carrying:
  Wad of Cash

>give cash to conductor
(Conductor)
You hand the Conductor the wad of cash. He flips through, quickly counting it, and nods.

"Alrighty. You're good to go!" You cringe on the inside. This corruption is not unfamiliar to you, but to engage in it yourself... that's wrong. "ALL ABOARD!" He yells. And steps inside the Train.

>s
the Sliding Door slid shut just as you leap into the Train Entrance car. You hear the train whir to life. Suddenly, you feel yourself stumble backwards, and find that outside, the scenery begins flying past. You hear the Conductor's voice again: "Hello everybody. We are now headed to the City. Relax, and enjoy your time during this journey."

Train Entrance
A rather small room with little furnishing. There is a small table with a few pamphlets on it. The walls of the Entrance room are mostly glass windows.  

You can see Sir Allan here.

>x black suit
You can't see any such thing.

>s
You can't go that way.

>n
You can't go that way.

I beg your pardon?

>e
Passenger Car
The room is longer than it is wide. There are about 30 open seats, but only a few are occupied. Along the walls are large glass windows. To the East is the Observation Car.

You can see Sir Allan's Luggage (closed), Combination Spin Lock (closed), Mark and Audrey here.

>w
Train Entrance
A rather small room with little furnishing. There is a small table with a few pamphlets on it. The walls of the Entrance room are mostly glass windows.  

You can see Sir Allan here.

>s
You can't go that way.

>open slide door
You can't see any such thing.

>open sliding door
But the train is moving.

>s
You can't go that way.

* * *

>n
You can't go that way.

>n
You can't go that way.

>e
Passenger Car
The room is longer than it is wide. There are about 30 open seats, but only a few are occupied. Along the walls are large glass windows. To the East is the Observation Car.

You can see Sir Allan's Luggage (closed), Combination Spin Lock (closed), Mark and Audrey here.

* * *

>n
You can't go that way.

>talk to sir allan
 You politely wave at Sir Allan, and he waves back. He approaches you inquires,

"Might you be a local here?" You nod. "Interesting. I've just come from the countryside after a wonderful vacation there, at my villa. I was born there, you know, in the spring of 1942. Back then, we were in the midst of the War. My father went to fight, and he never came back," you nod as Sir Allan elaborates his life story to you. He beams as he talks about his rise to wealth from poverty. You zone out, and eventually Sir Allan stops talking. 

You politely wave at Sir Allan, and he waves back.

>ask sir allan about luna's attempt to escape
"She came out of nowhere, and I realized something was wrong. So I stuck my leg out and tripped her. You came in just as I caught her." You nod. "I'm not going to let this little girl run away after what she did," he haughtily states. "You hear that?" He turns to Luna, "not after you killed my profit opportunity!" At this moment, several police officers rush into the Train Entrance. You explain what happened, and they swiftly arrest Luna.

    *** The End ***

Would you like to RESTART, RESTORE a saved game, QUIT or UNDO the last command?

>undo
Train Entrance
[Previous turn undone.]

>talk to sir allan
 You politely wave at Sir Allan, and he waves back. He approaches you inquires,

"Might you be a local here?" You nod. "Interesting. I've just come from the countryside after a wonderful vacation there, at my villa. I was born there, you know, in the spring of 1942. Back then, we were in the midst of the War. My father went to fight, and he never came back," you nod as Sir Allan elaborates his life story to you. He beams as he talks about his rise to wealth from poverty. You zone out, and eventually Sir Allan stops talking. 

You politely wave at Sir Allan, and he waves back.

>talk to sir allan
 You politely wave at Sir Allan, and he waves back. He approaches you inquires,

"Might you be a local here?" You nod. "Interesting. I've just come from the countryside after a wonderful vacation there, at my villa. I was born there, you know, in the spring of 1942. Back then, we were in the midst of the War. My father went to fight, and he never came back," you nod as Sir Allan elaborates his life story to you. He beams as he talks about his rise to wealth from poverty. You zone out, and eventually Sir Allan stops talking. 

You politely wave at Sir Allan, and he waves back.

* * *

>e
Wait. You still have to take your Lady's Flower, it should be on the table.

>speak to mayor
You push and squeeze through the crowd of angry villagers until you come to the Mayor. He does not even notice you until you shake him roughly on the shoulder. You ask "Sir, what is happening?"

"Him," he points to Edgar. "He just informed us that the Company has Felix."

You are taken aback. They have Felix?

"Your son, Felix?"

"Who else?!" The mayor cries angrily. "They want the damn rocks! Now they've resorted to this trickery and blackmailing. What villains!"

"What can we do?" You ask earnestly.

"I don't know," he says as he shakes his head, "Why don't we go into the house to speak."

"Alright." The mayor turns to Edgar and says in his booming voice,

"Enough!" The crowd goes silent. "Edgar. We will give you an answer soon. In the meantime, at least tell me where my son is."

Edgar laughs. "Now? Probably on the way to the Station. I will await your reply," he cackles as he walks away. The mob of villagers glare at Edgar, as he arrogantly strides away. When he is out of sight, the villagers begin to head back to their homes, grumbling to themselves.

You turn to the Mayor and he unlocks the door to his house. You follow him into the spacious mansion.

Mayor's House
When you walk into the house, you are stunned by the beautiful furnishing that seems to glitter in the house. At the center of the pearly marble white floor is a large glossy wooden table, on top of which is an elegant flower arrangement. Under a magnificent acrylic painting is a polished stone bench. Sitting on the bench is a worried-looking woman. She is the Mayor's wife, Annabelle.

>speak to mayor
"Mayor, I think we need to hurry." The Mayor closes his eyes and sinks to the floor.

"Yes," he murmurs, "We should. Sheriff, I need you to chase my son. I am well past my prime, and cannot leave the villagers. Our Lady only knows what they would do if I walked away from the town. Please go to the Station and save my son." You nod dutifully, and walk to the exit.

"Please take this," Annabelle says in a pale whisper, as she hands you a small velvet box.

Town Square
A square plaza with a cobblestone ground. Along the sides of the square are many two-story buildings. At the center of the square is a tall stone fountain, encircled by several wooden benches. Your cottage is to the West. East is the Mayor's House, and South is the Station. There is a crowd gathered outside the Mayor's door.

>s
Station
The Station is slow and idle. The town is not an attraction, and the Station is merely a stop for business men who need work in the city, or visit home. You see only a few people walking around, luggages in tow. Prominently in the center of the station is a large faded red ticket booth. Next to it is a small kiosk, selling beverages and food items. To the south is the Train, waiting to depart.  Leaning against one of the pillars is a tall lanky boy, who you recognize instantly: Felix. On either side of him are men in black suits, who Felix merrily jokes with. What in the world?

>speak to rita
You walk up to the counter, and say,

"Hi Ms. Rita. Long time no see, how have you been?" Her eyes focus, and she smiles grimly.

"Hello Marian,"

"Marcus", you correct.

"Marcus. You know, same old same old. How's ya mother? She good?" You nod.

"Yep. Uh, listen Rita. I need a ticket onto that train over there. How much does it cost?"

"Sorry, boy. Tickets are all sold out. Budget cuts, ya know? They're limiting passengers to lighten the load." You raise your brow. Budget cuts?

"This is really important. The Company's done something real bad this time."

"The Company?" Rita's eyes bulge, "Oh dear. Uh... Oh! You see the Conductor over there? Sometimes he allows some extra people onto the train in exchange for something in return. Ya know what I mean?"

"How much?"

"$20 dollahs."

"20!? That's daylight robbery!" She grabs a piece of scrap paper from her cluttered desk and scrawls something on it.

"Here," she says as she hands it to you. "Give it to the kiosk guy. He owes me."

I beg your pardon?

>give paper to guy
You firmly place the paper scrap onto the kiosk desk. The man looks up from his book, and takes it. He unfolds the paper, and the corner of his mouth tugs upward. He turns to the cash register, and takes out a wad of cash, carefully counting it before he hands it to you. He does not say a word, and returns to his book.

>give cash to conductor
You hand the Conductor the wad of cash. He flips through, quickly counting it, and nods.

"Alrighty. You're good to go!" You cringe on the inside. This corruption is not unfamiliar to you, but to engage in it yourself... that's wrong. "ALL ABOARD!" He yells. And steps inside the Train.

>n
Town Square
A square plaza with a cobblestone ground. Along the sides of the square are many two-story buildings. At the center of the square is a tall stone fountain, encircled by several wooden benches. Your cottage is to the West. East is the Mayor's House, and South is the Station. There is a crowd gathered outside the Mayor's door.

>s
Station
The Station is slow and idle. The town is not an attraction, and the Station is merely a stop for business men who need work in the city, or visit home. You see only a few people walking around, luggages in tow. Prominently in the center of the station is a large faded red ticket booth. Next to it is a small kiosk, selling beverages and food items. To the south is the Train, waiting to depart.

>s
the Sliding Door slid shut just as you leap into the Train Entrance car. You hear the train whir to life. Suddenly, you feel yourself stumble backwards, and find that outside, the scenery begins flying past. You hear the Conductor's voice again: "Hello everybody. We are now headed to the City. Relax, and enjoy your time during this journey."

Train Entrance
A rather small room with little furnishing. There is a small table with a few pamphlets on it. The walls of the Entrance room are mostly glass windows.

You can see Luna and Sir Allan here.

>e
Passenger Car
The room is longer than it is wide. There are about 30 open seats, but only a few are occupied. Along the walls are large glass windows. To the East is the Dining Car.

You can see Sir Allan's Luggage (closed), Combination Spin Lock (closed), Mark and Audrey here.

>e
Dining Car
The Dining Car has several long tables and benches. It kind of looks like a cafeteria. Occupying a large part of the car's corner is a counter with buffet-style food. To the North is the Bathroom. To the East is the Observation Car.

>n
The door is locked shut. You politely knock once. After a long minute of silence, you knock again. This time, you yell, "Is anybody there?!" Silence. You push the door with a bit of force.

"What in the world?" You slam your body against the door. You hear a slight crack.

You push again, and the lock breaks with a resounding clap. The door swings open and reveals the bathroom.

>n
Bathroom
A cramped single toilet room with one toilet and one sink.  A gust of wind blows in from the open window, and Felix's body sways slightly.

* * *

>speak to mayor
You can't see any such thing.

>s
Station
The Station is slow and idle. The town is not an attraction, and the Station is merely a stop for business men who need work in the city, or visit home. You see only a few people walking around, luggages in tow. Prominently in the center of the station is a large faded red ticket booth. Next to it is a small kiosk, selling beverages and food items. To the south is the Train, waiting to depart.  Leaning against one of the pillars is a tall lanky boy, who you recognize instantly: Felix. On either side of him are men in black suits, who Felix merrily jokes with. What in the world?

>s
You walk up to the Train Conductor, an elderly man with a sneer on his face. You say,

"Ah. Hello. I need to get on the train."

"Do you have a ticket?" He asks. You shake your head.

"Do you have anything else that can get you on the train?" He opens his palm towards you, facing upwards.

>talk to rita
You walk up to the counter, and say,

"Hi Ms. Rita. Long time no see, how have you been?" Her eyes focus, and she smiles grimly.

"Hello Marian,"

"Marcus", you correct.

"Marcus. You know, same old same old. How's ya mother? She good?" You nod.

"Yep. Uh, listen Rita. I need a ticket onto that train over there. How much does it cost?"

"Sorry, boy. Tickets are all sold out. Budget cuts, ya know? They're limiting passengers to lighten the load." You raise your brow. Budget cuts?

"This is really important. The Company's done something real bad this time."

"The Company?" Rita's eyes bulge, "Oh dear. Uh... Oh! You see the Conductor over there? Sometimes he allows some extra people onto the train in exchange for something in return. Ya know what I mean?"

"How much?"

"$20 dollahs."

"20!? That's daylight robbery!" She grabs a piece of scrap paper from her cluttered desk and scrawls something on it.

"Here," she says as she hands it to you. "Give it to the kiosk guy. He owes me."

>give paper to kiosk guy
You firmly place the paper scrap onto the kiosk desk. The man looks up from his book, and takes it. He unfolds the paper, and the corner of his mouth tugs upward. He turns to the cash register, and takes out a wad of cash, carefully counting it before he hands it to you. He does not say a word, and returns to his book.

>give money to conductor
You can't see any such thing.

>give cash to conductor
You hand the Conductor the wad of cash. He flips through, quickly counting it, and nods.

"Alrighty. You're good to go!" You cringe on the inside. This corruption is not unfamiliar to you, but to engage in it yourself... that's wrong. "ALL ABOARD!" He yells. And steps inside the Train.

>s
the Sliding Door slid shut just as you leap into the Train Entrance car. You hear the train whir to life. Suddenly, you feel yourself stumble backwards, and find that outside, the scenery begins flying past. You hear the Conductor's voice again: "Hello everybody. We are now headed to the City. Relax, and enjoy your time during this journey."

Train Entrance
A rather small room with little furnishing. There is a small table with a few pamphlets on it. The walls of the Entrance room are mostly glass windows.

You can see Luna and Sir Allan here.

* * *

>e
Dining Car
The Dining Car has several long tables and benches. It kind of looks like a cafeteria. Occupying a large part of the car's corner is a counter with buffet-style food. To the North is the Bathroom. To the East is the Observation Car.

>e
Observation Car
A long with glass window on the walls and ceiling. There are several couches facing the windows, so that people can watch the beautiful scenery fly by.

>w
Dining Car
The Dining Car has several long tables and benches. It kind of looks like a cafeteria. Occupying a large part of the car's corner is a counter with buffet-style food. To the North is the Bathroom. To the East is the Observation Car.

>w
Passenger Car
The room is longer than it is wide. There are about 30 open seats, but only a few are occupied. Along the walls are large glass windows. To the East is the Dining Car.

You can see Sir Allan's Luggage (closed), Combination Spin Lock (closed), Mark and Audrey here.

>x sir allan's luggage
A black cotton canvas luggage bag. Sir Allan's Luggage Bag is tucked into the corner of a rack.

>open sir allan's luggage
You try to open the Luggage, but it appears to be locked by a combination spin lock.

I beg your pardon?

>open sir allan's luggage
You try to open the Luggage, but it appears to be locked by a combination spin lock.

>take book
You can't see any such thing.

>take notebook
You can't see any such thing.

>close luggage
It isn't something you can close.

I beg your pardon?

>spin lock to 1942
You hear a satisfying and firm click, and the lock pops open. You unzip the largest pocket and look inside. There are several notebooks and files. Strange for man coming back from a retirement vacation. One of the notebooks, a Purple Notebook, catches your eye.

>open notebook
It isn't something you can open.

>take notebook
Taken.

I beg your pardon?

>read notebook
Start by reading page 1 of Purple Notebook.

>x book
You can't see any such thing.

>x notebook
The cover of the notebook contains a familiar pattern. You take out your Lady's Flower and find that the design look awfully similar. Start by reading page 1 of Purple Notebook.

I beg your pardon?

* * *

>read notebook
Start by reading page 1 of Purple Notebook.

I beg your pardon?

>read page 1 of notebook
You read: "page 1."

I beg your pardon?

>i
You are carrying:
  SirAllanInformation 3
  Purple Notebook
  Wad of Cash
  Velvet Box

I beg your pardon?

* * *

>i
You are carrying:
  SirAllanInformation 3
  Purple Notebook
  Wad of Cash
  Velvet Box

>l
Passenger Car
The room is longer than it is wide. There are about 30 open seats, but only a few are occupied. Along the walls are large glass windows. To the East is the Dining Car.

You can see Sir Allan's Luggage (empty), Combination Spin Lock (closed), Mark and Audrey here.

>e
Dining Car
The Dining Car has several long tables and benches. It kind of looks like a cafeteria. Occupying a large part of the car's corner is a counter with buffet-style food. To the North is the Bathroom. To the East is the Observation Car.

>open door
You can't see any such thing.

>open blue door
You can't see any such thing.

I beg your pardon?

>x blue door
You can't see any such thing.

I beg your pardon?

>n
Bathroom
A cramped single toilet room with one toilet and one sink.  A gust of wind blows in from the open window, and Felix's body sways slightly.

You can see a Blue Door here.

I beg your pardon?

>s
(first opening the Blue Door)
The door is locked shut. You politely knock once. After a long minute of silence, you knock again. This time, you yell, "Is anybody there?!" Silence. You push the door with a bit of force.

"What in the world?" You slam your body against the door. You hear a slight crack.

>n
You can't go that way.

>s
(first opening the Blue Door)

Dining Room
You can see a Blue Door here.

I beg your pardon?

>n
Bathroom
A cramped single toilet room with one toilet and one sink.  A gust of wind blows in from the open window, and Felix's body sways slightly.

You can see Blue Door here.

>s
Dining Room
You can see Blue Door here.

I beg your pardon?

* * *

>s
Dining Room
You can see Blue Door here.

>n
Bathroom
A cramped single toilet room with one toilet and one sink.  A gust of wind blows in from the open window, and Felix's body sways slightly.

You can see Blue Door here.

>n
You can't go that way.

>s
Dining Room
You can see Blue Door here.

* * *

I beg your pardon?

>s
Dining Room
You can see a Blue Door here.

I beg your pardon?

* * *

>n
Bathroom
A cramped single toilet room with one toilet and one sink.  A gust of wind blows in from the open window, and Felix's body sways slightly.

You can see a Blue Door here.

>s
Dining Room
You can see a Blue Door here.

>n
Bathroom
A cramped single toilet room with one toilet and one sink.  A gust of wind blows in from the open window, and Felix's body sways slightly.

You can see a Blue Door here.

>n
You can't go that way.

>s
Dining Room
You can see a Blue Door here.

>s
You can't go that way.

>e
You can't go that way.

* * *

>w
You can't go that way.

>d
You can't go that way.

>n
Bathroom
A cramped single toilet room with one toilet and one sink.  A gust of wind blows in from the open window, and Felix's body sways slightly.

You can see a Blue Door here.

* * *

>read notebook
Start by reading page 1 of Purple Notebook.

>read page 1 of notebook
You read: "page 1."

>i
You are carrying:
  SirAllanInformation 3
  Purple Notebook
  Wad of Cash
  Velvet Box

* * *

I beg your pardon?

>n
Bathroom
A cramped single toilet room with one toilet and one sink.  A gust of wind blows in from the open window, and Felix's body sways slightly.

I beg your pardon?

>s
Dining Car
The Dining Car has several long tables and benches. It kind of looks like a cafeteria. Occupying a large part of the car's corner is a counter with buffet-style food. To the North is the Bathroom. To the East is the Observation Car.

>n
Bathroom
A cramped single toilet room with one toilet and one sink.  A gust of wind blows in from the open window, and Felix's body sways slightly.

>s
Dining Car
The Dining Car has several long tables and benches. It kind of looks like a cafeteria. Occupying a large part of the car's corner is a counter with buffet-style food. To the North is the Bathroom. To the East is the Observation Car.

I beg your pardon?

* * *

>e
Wait. You still have to take your Lady's Flower, it should be on the table.

>talk to mayor
You push and squeeze through the crowd of angry villagers until you come to the Mayor. He does not even notice you until you shake him roughly on the shoulder. You ask "Sir, what is happening?"

"Him," he points to Edgar. "He just informed us that the Company has Felix."

You are taken aback. They have Felix?

"Your son, Felix?"

"Who else?!" The mayor cries angrily. "They want the damn rocks! Now they've resorted to this trickery and blackmailing. What villains!"

"What can we do?" You ask earnestly.

"I don't know," he says as he shakes his head, "Why don't we go into the house to speak."

"Alright." The mayor turns to Edgar and says in his booming voice,

"Enough!" The crowd goes silent. "Edgar. We will give you an answer soon. In the meantime, at least tell me where my son is."

Edgar laughs. "Now? Probably on the way to the Station. I will await your reply," he cackles as he walks away. The mob of villagers glare at Edgar, as he arrogantly strides away. When he is out of sight, the villagers begin to head back to their homes, grumbling to themselves.

You turn to the Mayor and he unlocks the door to his house. You follow him into the spacious mansion.

Mayor's House
When you walk into the house, you are stunned by the beautiful furnishing that seems to glitter in the house. At the center of the pearly marble white floor is a large glossy wooden table, on top of which is an elegant flower arrangement. Under a magnificent acrylic painting is a polished stone bench. Sitting on the bench is a worried-looking woman. She is the Mayor's wife, Annabelle.

>talk to mayor
"Mayor, I think we need to hurry." The Mayor closes his eyes and sinks to the floor.

"Yes," he murmurs, "We should. Sheriff, I need you to chase my son. I am well past my prime, and cannot leave the villagers. Our Lady only knows what they would do if I walked away from the town. Please go to the Station and save my son." You nod dutifully, and walk to the exit.

"Please take this," Annabelle says in a pale whisper, as she hands you a small velvet box.

Town Square
A square plaza with a cobblestone ground. Along the sides of the square are many two-story buildings. At the center of the square is a tall stone fountain, encircled by several wooden benches. Your cottage is to the West. East is the Mayor's House, and South is the Station. There is a crowd gathered outside the Mayor's door.

>s
Station
The Station is slow and idle. The town is not an attraction, and the Station is merely a stop for business men who need work in the city, or visit home. You see only a few people walking around, luggages in tow. Prominently in the center of the station is a large faded red ticket booth. Next to it is a small kiosk, selling beverages and food items. To the south is the Train, waiting to depart.  Leaning against one of the pillars is a tall lanky boy, who you recognize instantly: Felix. On either side of him are men in black suits, who Felix merrily jokes with. What in the world?

>speak to felix
You stride towards Felix, and slap him across the face. He is dumbfounded for a moment, and registers who you are. He gestures apologetically to the the men in suits and they walk away.

"You ignorant boy. What are you doing?" You shout at him.

"I'm going to the city, Sheriff," he retorts. "I'm sick of that stupid village. I don't want to inherit the position of mayor when I have the potential to do so much more. Luckily, the Company realized this and offered to relocate me. They're bringing me to the city, it's going to be wonderful!"

"You don't understand. Right now the Company has told your father that they are holding you in their custody. They said that if the villagers don't yield the Lady's Flower, they'll harm you."

"Don't joke with me. That old fart's probably willing to say anything to get me back to the village. And once they do, they'll never let me leave again."

"You shut up! If the villagers do end up handing over the stones, they'll catch up and toss you back into the village. Please Felix, come to your sense."

"No! I can't stay there. Even if your story is true, the villagers would never hand over the stupid rocks. My benefactor A-" The speakers in the Station blare out:

"Train 342 to the City is departing in 5 minutes-please board now. Thank you." Felix looks at you, then shoves you out of the way to board the train.

>i
You are carrying:
  Velvet Box

>l
Station
The Station is slow and idle. The town is not an attraction, and the Station is merely a stop for business men who need work in the city, or visit home. You see only a few people walking around, luggages in tow. Prominently in the center of the station is a large faded red ticket booth. Next to it is a small kiosk, selling beverages and food items. To the south is the Train, waiting to depart.

>n
Town Square
A square plaza with a cobblestone ground. Along the sides of the square are many two-story buildings. At the center of the square is a tall stone fountain, encircled by several wooden benches. Your cottage is to the West. East is the Mayor's House, and South is the Station. There is a crowd gathered outside the Mayor's door.

* * *

>s
Station
The Station is slow and idle. The town is not an attraction, and the Station is merely a stop for business men who need work in the city, or visit home. You see only a few people walking around, luggages in tow. Prominently in the center of the station is a large faded red ticket booth. Next to it is a small kiosk, selling beverages and food items. To the south is the Train, waiting to depart.

>talk to rita
You walk up to the counter, and say,

"Hi Ms. Rita. Long time no see, how have you been?" Her eyes focus, and she smiles grimly.

"Hello Marian,"

"Marcus", you correct.

"Marcus. You know, same old same old. How's ya mother? She good?" You nod.

"Yep. Uh, listen Rita. I need a ticket onto that train over there. How much does it cost?"

"Sorry, boy. Tickets are all sold out. Budget cuts, ya know? They're limiting passengers to lighten the load." You raise your brow. Budget cuts?

"This is really important. The Company's done something real bad this time."

"The Company?" Rita's eyes bulge, "Oh dear. Uh... Oh! You see the Conductor over there? Sometimes he allows some extra people onto the train in exchange for something in return. Ya know what I mean?"

"How much?"

"$20 dollahs."

"20!? That's daylight robbery!" She grabs a piece of scrap paper from her cluttered desk and scrawls something on it.

"Here," she says as she hands it to you. "Give it to the kiosk guy. He owes me."

* * *

>give paper to kiosk guy
You firmly place the paper scrap onto the kiosk desk. The man looks up from his book, and takes it. He unfolds the paper, and the corner of his mouth tugs upward. He turns to the cash register, and takes out a wad of cash, carefully counting it before he hands it to you. He does not say a word, and returns to his book.

>give cash to conductor
You hand the Conductor the wad of cash. He flips through, quickly counting it, and nods.

"Alrighty. You're good to go!" You cringe on the inside. This corruption is not unfamiliar to you, but to engage in it yourself... that's wrong. "ALL ABOARD!" He yells. And steps inside the Train.

* * *

>e
Dining Car
The Dining Car has several long tables and benches. It kind of looks like a cafeteria. Occupying a large part of the car's corner is a counter with buffet-style food. To the North is the Bathroom. To the East is the Observation Car.

>n
Bathroom
A cramped single toilet room with one toilet and one sink.  At the center of the bathroom is a horrible sight: Felix's body hangs from a rope, wound around his neck, that is tied to the ceiling.  A gust of wind blows in from the open window, and Felix's body sways slightly.

>e
You can't go that way.

>s
You can't go that way.

>undo
Bathroom
[Previous turn undone.]

>undo
Dining Car
[Previous turn undone.]

>undo
Passenger Car
[Previous turn undone.]

>e
Dining Car
The Dining Car has several long tables and benches. It kind of looks like a cafeteria. Occupying a large part of the car's corner is a counter with buffet-style food. To the North is the Bathroom. To the East is the Observation Car.

* * *

>n
Bathroom
A cramped single toilet room with one toilet and one sink.  At the center of the bathroom is a horrible sight: Felix's body hangs from a rope, wound around his neck, that is tied to the ceiling.  A gust of wind blows in from the open window, and Felix's body sways slightly.

>s
You can't go that way.

>l
Bathroom
A cramped single toilet room with one toilet and one sink.  At the center of the bathroom is a horrible sight: Felix's body hangs from a rope, wound around his neck, that is tied to the ceiling.  A gust of wind blows in from the open window, and Felix's body sways slightly.

I beg your pardon?

* * *

>s
You can't go that way.

>ns
That's not a verb I recognise.

>n
You can't go that way.

* * *

>s
Station
The Station is slow and idle. The town is not an attraction, and the Station is merely a stop for business men who need work in the city, or visit home. You see only a few people walking around, luggages in tow. Prominently in the center of the station is a large faded red ticket booth. Next to it is a small kiosk, selling beverages and food items. To the south is the Train, waiting to depart.

I beg your pardon?

>s
the Sliding Door slid shut just as you leap into the Train Entrance car. You hear the train whir to life. Suddenly, you feel yourself stumble backwards, and find that outside, the scenery begins flying past. You hear the Conductor's voice again: "Hello everybody. We are now headed to the City. Relax, and enjoy your time during this journey."

Train Entrance
A rather small room with little furnishing. There is a small table with a few pamphlets on it. The walls of the Entrance room are mostly glass windows.

You can see Luna and Sir Allan here.

* * *

>e
Dining Car
The Dining Car has several long tables and benches. It kind of looks like a cafeteria. Occupying a large part of the car's corner is a counter with buffet-style food. To the North is the Bathroom. To the East is the Observation Car.

>n
The door is locked shut. You politely knock once. After a long minute of silence, you knock again. This time, you yell, "Is anybody there?!" Silence. You push the door with a bit of force.

"What in the world?" You slam your body against the door. You hear a slight crack.

You push again, and the lock breaks with a resounding clap.

>e
Observation Car
A long with glass window on the walls and ceiling. There are several couches facing the windows, so that people can watch the beautiful scenery fly by.

>s
You can't go that way.

>undo
Observation Car
[Previous turn undone.]

>undo
Dining Car
[Previous turn undone.]

>undo
Dining Car
[Previous turn undone.]

* * *

>n
The door is locked shut. You politely knock once. After a long minute of silence, you knock again. This time, you yell, "Is anybody there?!" Silence. You push the door with a bit of force.

"What in the world?" You slam your body against the door. You hear a slight crack.

You push again, and the lock breaks with a resounding clap.

>s
You can't go that way.

>n
Bathroom
A cramped single toilet room with one toilet and one sink.  At the center of the bathroom is a horrible sight: Felix's body hangs from a rope, wound around his neck, that is tied to the ceiling.  A gust of wind blows in from the open window, and Felix's body sways slightly.

>s
Dining Car
The Dining Car has several long tables and benches. It kind of looks like a cafeteria. Occupying a large part of the car's corner is a counter with buffet-style food. To the North is the Bathroom. To the East is the Observation Car.

>l
Dining Car
The Dining Car has several long tables and benches. It kind of looks like a cafeteria. Occupying a large part of the car's corner is a counter with buffet-style food. To the North is the Bathroom. To the East is the Observation Car.

I beg your pardon?

>e
Observation Car
A long with glass window on the walls and ceiling. There are several couches facing the windows, so that people can watch the beautiful scenery fly by.

* * *

>e
You can't go that way.

>w
Dining Car
The Dining Car has several long tables and benches. It kind of looks like a cafeteria. Occupying a large part of the car's corner is a counter with buffet-style food. To the North is the Bathroom. To the East is the Observation Car.

>n
Bathroom
A cramped single toilet room with one toilet and one sink.  At the center of the bathroom is a horrible sight: Felix's body hangs from a rope, wound around his neck, that is tied to the ceiling.  A gust of wind blows in from the open window, and Felix's body sways slightly.

>l
Bathroom
A cramped single toilet room with one toilet and one sink.  At the center of the bathroom is a horrible sight: Felix's body hangs from a rope, wound around his neck, that is tied to the ceiling.  A gust of wind blows in from the open window, and Felix's body sways slightly.

* * *

>give paper to guy
You firmly place the paper scrap onto the kiosk desk. The man looks up from his book, and takes it. He unfolds the paper, and the corner of his mouth tugs upward. He turns to the cash register, and takes out a wad of cash, carefully counting it before he hands it to you. He does not say a word, and returns to his book.

>give cash to conductor
(Conductor)
You hand the Conductor the wad of cash. He flips through, quickly counting it, and nods.

"Alrighty. You're good to go!" You cringe on the inside. This corruption is not unfamiliar to you, but to engage in it yourself... that's wrong. "ALL ABOARD!" He yells. And steps inside the Train.

>n
Town Square
A square plaza with a cobblestone ground. Along the sides of the square are many two-story buildings. At the center of the square is a tall stone fountain, encircled by several wooden benches. Your cottage is to the West. East is the Mayor's House, and South is the Station. There is a crowd gathered outside the Mayor's door.

* * *

>s
Station
The Station is slow and idle. The town is not an attraction, and the Station is merely a stop for business men who need work in the city, or visit home. You see only a few people walking around, luggages in tow. Prominently in the center of the station is a large faded red ticket booth. Next to it is a small kiosk, selling beverages and food items. To the south is the Train, waiting to depart.

>s
the Sliding Door slid shut just as you leap into the Train Entrance car. You hear the train whir to life. Suddenly, you feel yourself stumble backwards, and find that outside, the scenery begins flying past. You hear the Conductor's voice again: "Hello everybody. We are now headed to the City. Relax, and enjoy your time during this journey."

Train Entrance
A rather small room with little furnishing. There is a small table with a few pamphlets on it. The walls of the Entrance room are mostly glass windows.  

You can see Case Solved and Sir Allan here.

>e
Passenger Car
The room is longer than it is wide. There are about 30 open seats, but only a few are occupied. Along the walls are large glass windows. To the East is the Observation Car.

You can see Sir Allan's Luggage (closed), Combination Spin Lock (closed), Mark and Audrey here.

>e
Observation Car
A long with glass window on the walls and ceiling. There are several couches facing the windows, so that people can watch the beautiful scenery fly by.

You can see Luna's Purse (closed) and Luna here.

I beg your pardon?

>l
Observation Car
A long with glass window on the walls and ceiling. There are several couches facing the windows, so that people can watch the beautiful scenery fly by.

You can see Luna's Purse (closed) and Luna here.

I beg your pardon?

* * *

>e
You can't go that way.

>w
Passenger Car
The room is longer than it is wide. There are about 30 open seats, but only a few are occupied. Along the walls are large glass windows. To the East is the Observation Car.

You can see Sir Allan's Luggage (closed), Combination Spin Lock (closed), Mark and Audrey here.

>w
Train Entrance
A rather small room with little furnishing. There is a small table with a few pamphlets on it. The walls of the Entrance room are mostly glass windows.  

You can see Case Solved and Sir Allan here.

>e
Passenger Car
The room is longer than it is wide. There are about 30 open seats, but only a few are occupied. Along the walls are large glass windows. To the East is the Observation Car.

You can see Sir Allan's Luggage (closed), Combination Spin Lock (closed), Mark and Audrey here.

* * *

>e
Observation Car
A long with glass window on the walls and ceiling. There are several couches facing the windows, so that people can watch the beautiful scenery fly by.

You can see Luna's Purse (closed) and Luna here.

>e
You can't go that way.

* * *

>n
You can't go that way.

>i
You are carrying:
  Wad of Cash
  Velvet Box

>l
Observation Car
A long with glass window on the walls and ceiling. There are several couches facing the windows, so that people can watch the beautiful scenery fly by.

You can see Luna's Purse (closed) and Luna here.

>s
You can't go that way.

* * *

>e
You can't go that way.

>e
You can't go that way.

* * *

>w
Passenger Car
The room is longer than it is wide. There are about 30 open seats, but only a few are occupied. Along the walls are large glass windows. To the East is the Observation Car.

You can see Sir Allan's Luggage (closed), Combination Spin Lock (closed), Mark and Audrey here.

>e
Observation Car
A long with glass window on the walls and ceiling. There are several couches facing the windows, so that people can watch the beautiful scenery fly by.

You can see Luna's Purse (closed) and Luna here.

>s
You can't go that way.

* * *

>n
You can't go that way.

>e
You can't go that way.

* * *

>w
Passenger Car
The room is longer than it is wide. There are about 30 open seats, but only a few are occupied. Along the walls are large glass windows. To the East is the Observation Car.

You can see Sir Allan's Luggage (closed), Combination Spin Lock (closed), Mark and Audrey here.

>s
You can't go that way.

>e
Observation Car
A long with glass window on the walls and ceiling. There are several couches facing the windows, so that people can watch the beautiful scenery fly by.

You can see Luna's Purse (closed) and Luna here.

>take novel
You examine the novel, and you see absolutely no trace of it ever being opened.

>talk to luna
You can ask Luna about:

Herself.

The purpose of her journey.

What she was doing and where when the crime happened.

The victim.

Anything suspicious.

.

>ask luna about her guilt
You accuse Luna of murdering Felix, to which she refuses. You being presenting the evidence, and she gets angry. suddenly, the train stops, and luna runs towards the Train Entrance.

I beg your pardon?

>l
Observation Car
A long with glass window on the walls and ceiling. There are several couches facing the windows, so that people can watch the beautiful scenery fly by.

You can see Luna's Purse (closed) here.

>undo
Observation Car
[Previous turn undone.]

>undo
Observation Car
[Previous turn undone.]

>talk to luna
You can ask Luna about:

Herself.

The purpose of her journey.

What she was doing and where when the crime happened.

The victim.

Anything suspicious.

.

>undo
Observation Car
[Previous turn undone.]

>l
Observation Car
A long with glass window on the walls and ceiling. There are several couches facing the windows, so that people can watch the beautiful scenery fly by.

You can see Luna's Purse (closed) and Luna here.

>open purse
You open the purse and rummage around. Inside, she carries a makeup bag, a wallet, and a silk belt.

>take silk belt
You pull the Silk Belt out of the purse, and marvel at its length.  You also pick up the Novel, which was sitting on the Couch.

>l
Observation Car
A long with glass window on the walls and ceiling. There are several couches facing the windows, so that people can watch the beautiful scenery fly by.

You can see Luna's Purse (in which is Makeup Bag (closed)) and Luna here.

>open purse
That's already open.

>l
Observation Car
A long with glass window on the walls and ceiling. There are several couches facing the windows, so that people can watch the beautiful scenery fly by.

You can see Luna's Purse (in which is Makeup Bag (closed)) and Luna here.

>i
You are carrying:
  Novel
  Silk Belt
  Wallet (closed)
  LunaInformation 4
  Wad of Cash
  Velvet Box

* * *

>e
Wait. You still have to take your Lady's Flower, it should be on the table.

>e
Wait. You still have to take your Lady's Flower, it should be on the table.

>take stone
Taken.

* * *

>e
Town Square
A square plaza with a cobblestone ground. Along the sides of the square are many two-story buildings. At the center of the square is a tall stone fountain, encircled by several wooden benches. Your cottage is to the West. East is the Mayor's House. There is a crowd gathered outside the Mayor's House.

>talk to mayor
You push and squeeze through the crowd of angry villagers until you come to the Mayor. He does not even notice you until you shake him roughly on the shoulder. You have to shout for him to hear you, "Sir, what is happening?"

"Him," he points to Edgar. "He just informed us that the Company has Felix."

You are taken aback. They have Felix?

"Your son, Felix?"

"Who else?!" The mayor cries angrily. "They want the damn rocks! Now they've resorted to this trickery and blackmailing. What villains!"

"What can we do?" You ask earnestly.

"I don't know," he says as he shakes his head, "Why don't we go into the house to speak."

"Alright." The mayor turns to Edgar and says in his booming voice,

"Enough!" The crowd goes silent. "Edgar. We will give you an answer soon. In the meantime, at least tell me where my son is."

Edgar laughs. "Now? Probably on the way to the City. I will await your reply," he cackles as he walks away. The mob of villagers glare at Edgar, as he arrogantly strides away. When he is out of sight, the villagers begin to head back to their homes, grumbling to themselves.

You turn to the Mayor and he unlocks the door to his house. You follow him into the spacious mansion.

Mayor's House
When you walk into the house, you are stunned by the beautiful furnishing that seems to glitter in the house. At the center of the pearly marble white floor is a large glossy wooden dining table, on top of which is an elegant flower arrangement. Under a magnificent acrylic painting is a polished large leather sofa. The Mayor plops down on the sofa and deflates.

* * *

>talk to rita
You walk up to the counter, and say,

"Hi Ms. Rita. Long time no see, how have you been?" Her eyes focus, and she smiles grimly.

"Hello Marian,"

"Marcus", you correct.

"Marcus. You know, same old same old. How's ya mother? She good?" You nod.

"Yep. Uh, listen Rita. I need a ticket onto that train over there. How much does it cost?"

"Sorry, boy. Tickets are all sold out. Budget cuts, ya know? They're limiting passengers to lighten the load." You raise your brow. Budget cuts?

"This is really important. The Company's done something real bad this time."

"The Company?" Rita's eyes bulge, "Oh dear. Uh... Oh! You see the Conductor over there? Sometimes he allows some extra people onto the train in exchange for something in return. Ya know what I mean?"

"How much?"

"$20 dollahs."

"20!? That's daylight robbery!" She grabs a piece of scrap paper from her cluttered desk and scrawls something on it.

"Here," she says as she hands it to you. "Give it to the kiosk guy. He owes me."

>talk to kiosk guy
You approach the Kiosk Guy, who is intently reading his book. You say, "Uh. Hello. Can you help me?"

He immediately looks up. The glare in his face startles you, and you back away.

>give kiosk guy paper
You firmly place the paper scrap onto the kiosk desk. The man looks up from his book, and takes it. He unfolds the paper, and the corner of his mouth tugs upward. He turns to the cash register, and takes out a wad of cash, carefully counting it before he hands it to you. He does not say a word, and returns to his book.

* * *

>take all
There are none at all available!

* * *

>s
You can't go that way.

>e
Town Square
A square plaza with a cobblestone ground. Along the sides of the square are many two-story buildings. At the center of the square is a tall stone fountain, encircled by several wooden benches. Your cottage is to the West. East is the Mayor's House. There is a crowd gathered outside the Mayor's House.

* * *

>s
You have no reason to go to the Station.

>speak to mayor
You push and squeeze through the crowd of angry villagers until you come to the Mayor. He does not even notice you until you shake him roughly on the shoulder. You have to shout for him to hear you, "Sir, what is happening?"

"Him," he points to Edgar. "He just informed us that the Company has Felix."

You are taken aback. They have Felix?

"Your son, Felix?"

"Who else?!" The mayor cries angrily. "They want the damn rocks! Now they've resorted to this trickery and blackmailing. What villains!"

"What can we do?" You ask earnestly.

"I don't know," he says as he shakes his head, "Why don't we go into the house to speak."

"Alright." The mayor turns to Edgar and says in his booming voice,

"Enough!" The crowd goes silent. "Edgar. We will give you an answer soon. In the meantime, at least tell me where my son is."

Edgar laughs. "Now? Probably on the way to the City. I will await your reply," he cackles as he walks away. The mob of villagers glare at Edgar, as he arrogantly strides away. When he is out of sight, the villagers begin to head back to their homes, grumbling to themselves.

You turn to the Mayor and he unlocks the door to his house. You follow him into the spacious mansion.

Mayor's House
When you walk into the house, you are stunned by the beautiful furnishing that seems to glitter in the house. At the center of the pearly marble white floor is a large glossy wooden dining table, on top of which is an elegant flower arrangement. Under a magnificent acrylic painting is a polished large leather sofa. The Mayor plops down on the sofa and deflates.

>speak to mayor
"Mayor, I think we need to hurry." The Mayor closes his eyes.

"Yes," he murmurs, "We should. Alex, I need you to chase my son. I am well past my prime, and cannot leave the villagers. Our Lady only knows what they would do if I walked away from the town. Please go to the Station and save my son." You nod dutifully, and walk to the exit.

Station
The Station is slow and idle. The town is not an attraction, and the Station is merely a stop for business men who need work in the city, or visit home. You see only a few business men walking around, luggages in tow. Prominently in the center of the station is a large faded red ticket booth. Next to it is a small kiosk, selling beverages and food items. To the south is the Train, waiting to depart.  Leaning against one of the pillars is a tall lanky boy, who you recognize instantly: Felix. Next to him is a man in a black suit, who Felix merrily jokes with. What in the world?

>speak to black suit
You greet the man in the Black Suit, but he looks at you and you immediately shut up.

>x black suit
Man in Black suit.

>speak to felix
You stride towards Felix, and slap him across the face. He is dumbfounded for a moment before registering who you are. He gestures apologetically to the the men in suits and they walk away.

"You ignorant boy. What are you doing?" You shout at him.

"I'm going to the city, Alex," he retorts. "I'm sick of that stupid village. I don't want to inherit the position of mayor when I have the potential to do so much more. Luckily, the Company realized this and offered to relocate me. They're bringing me to the city, it's going to be wonderful!"

"You don't understand. Right now the Company has told your father that they are holding you in their custody. They said that if the villagers don't yield the Lady's Flower, they'll harm you."

"Don't joke with me. That old fart's probably willing to say anything to get me back to the village. And once they do, they'll never let me leave again."

"You shut up! If the villagers do end up handing over the stones, they'll catch up and toss you back into the village. Please Felix, come to your sense."

"No! I can't stay there. Even if your story is true, the villagers would never hand over the stupid rocks. They have too much prided for that!" The speakers in the Station suddenly blare out:

"Train 342 to the City is departing in 5 minutes-please board now. Thank you." Felix looks at you, then shoves you out of the way to gather his belongings.

>l
Station
The Station is slow and idle. The town is not an attraction, and the Station is merely a stop for business men who need work in the city, or visit home. You see only a few business men walking around, luggages in tow. Prominently in the center of the station is a large faded red ticket booth. Next to it is a small kiosk, selling beverages and food items. To the south is the Train, waiting to depart.  Leaning against one of the pillars is a tall lanky boy, who you recognize instantly: Felix. Next to him is a man in a black suit, who Felix merrily jokes with. What in the world?

>talk to black suit
You can't see any such thing.

>talk to rita
You walk up to the counter, and say,

"Hi Ms. Rita. Long time no see, how have you been?" Her eyes focus, and she smiles grimly.

"Hello Marian,"

"Marcus", you correct.

"Marcus. You know, same old same old. How's ya mother? She good?" You nod.

"Yep. Uh, listen Rita. I need a ticket onto that train over there. How much does it cost?"

"Sorry, boy. Tickets are all sold out. Budget cuts, ya know? They're limiting passengers to lighten the load." You raise your brow. Budget cuts?

"This is really important. The Company's done something real bad this time."

"The Company?" Rita's eyes bulge, "Oh dear. Uh... Oh! You see the Conductor over there? Sometimes he allows some extra people onto the train in exchange for something in return. Ya know what I mean?"

"How much?"

"$20 dollahs."

"20!? That's daylight robbery!" She grabs a piece of scrap paper from her cluttered desk and scrawls something on it.

"Here," she says as she hands it to you. "Give it to the kiosk guy. He owes me."

* * *

>give cash to conductor
(Conductor)
You hand the Conductor the wad of cash. He flips through, quickly counting it, and nods.

"Alrighty. You're good to go!" You cringe on the inside. This corruption is not unfamiliar to you, but to engage in it yourself... that's wrong. "ALL ABOARD!" He yells. And steps inside the Train.

>s
the Sliding Door slid shut just as you leap into the Train Entrance car. You hear the train whir to life. Suddenly, you feel yourself stumble backwards, and find that outside, the scenery begins flying past. You hear the Conductor's voice again: "Hello everybody. We are now headed to the City. Relax, and enjoy your time during this journey."

Train Entrance
A rather small room with little furnishing. The walls of the Entrance room are mostly glass windows.  

You can see Sir Allan here.

>x black suit
 Black Suit is pacing around.

>talk to black suit
You approach Black Suit again, and he grunts.

"Where is Felix?" You demand.

"If I knew, I wouldn't be pacing! I don't know. He went to the restroom and never came back."

>e
Passenger Car
The room is longer than it is wide. There are about 30 open seats, but only a few are occupied. Along the walls are large glass windows. To the East is the Observation Car.

You can see Mark and Audrey here.

* * *

>e
Observation Car
A long with glass window on the walls and ceiling. There are several couches facing the windows, so that people can watch the beautiful scenery fly by. On one of the couches is Luna's purse, which is placed on top of a Novel..

You can see Luna here.

I beg your pardon?

>w
Passenger Car
The room is longer than it is wide. There are about 30 open seats, but only a few are occupied. Along the walls are large glass windows. To the East is the Observation Car.

You can see Mark and Audrey here.