You wake up to shouts and loud banging. It is early; the sun has just begun to rise. After groggily getting out from bed, you peer out the window. There is a crowd of people gathered outside in front of the Mayor's House.  It's too early! What is happening?

Mercenaries
An Interactive Fiction by Elana Shi
Release 1 / Serial number 141022 / Inform 7 build 6L38 (I6/v6.33 lib 6/12N) SD

Cottage
A small one room compartment. Shoved into the corner of the room is your bed. Next to the door is your sorry excuse of a kitchen: a small stove, and a sink. At the center of the room is a squat wooden table with the stone on it. On the wall above your sink is a small one way window that looks into Town Square. You can go to Town Square by going East.

I beg your pardon?

* * *

>rules on
Rules tracing now switched on. Type "rules off" to switch it off again, or "rules all" to include even rules which do not apply.

* * *

>e
Town Square
A square plaza with a cobblestone ground. Along the sides of the square are many two-story buildings. At the center of the square is a tall stone fountain, encircled by several wooden benches. Your cottage is to the West. East is the Mayor's House, and South is the Station. There is a crowd gathered outside the Mayor's door.

>talk to mayor
You push and squeeze through the crowd of angry villagers until you come to the Mayor. He does not even notice you until you shake him roughly on the shoulder. You ask "Sir, what is happening?"

"Him," he points to Edgar. "He just informed us that the Company has Felix."

You are taken aback. They have Felix?

"Your son, Felix?"

"Who else?!" The mayor cries angrily. "They want the damn rocks! Now they've resorted to this trickery and blackmailing. What villains!"

"What can we do?" You ask earnestly.

"I don't know," he says as he shakes his head, "Why don't we go into the house to speak."

"Alright." The mayor turns to Edgar and says in his booming voice,

"Enough!" The crowd goes silent. "Edgar. We will give you an answer soon. In the meantime, at least tell me where my son is."

Edgar laughs. "Now? Probably on the way to the Station. I will await your reply," he cackles as he walks away. The mob of villagers glare at Edgar, as he arrogantly strides away. When he is out of sight, the villagers begin to head back to their homes, grumbling to themselves.

You turn to the Mayor and he unlocks the door to his house. You follow him into the spacious mansion.

Mayor's House
When you walk into the house, you are stunned by the beautiful furnishing that seems to glitter in the house. At the center of the pearly marble white floor is a large glossy wooden table, on top of which is an elegant flower arrangement. Under a magnificent acrylic painting is a polished stone bench. Sitting on the bench is a worried-looking woman. She is the Mayor's wife, Annabelle.

* * *

I beg your pardon?

* * *

>s
Station
The Station is slow and idle. The town is not an attraction, and the Station is merely a stop for business men who need work in the city, or visit home. You see only a few people walking around, luggages in tow. Prominently in the center of the station is a large faded red ticket booth. Next to it is a small kiosk, selling beverages and food items. To the south is the Train, waiting to depart.  Leaning against one of the pillars is a tall lanky boy, who you recognize instantly: Felix. On either side of him are men in black suits, who Felix merrily jokes with. What in the world?

>talk to rita
You walk up to the counter, and say,

"Hi Ms. Rita. Long time no see, how have you been?" Her eyes focus, and she smiles grimly.

"Hello Marian,"

"Marcus", you correct.

"Marcus. You know, same old same old. How's ya mother? She good?" You nod.

"Yep. Uh, listen Rita. I need a ticket onto that train over there. How much does it cost?"

"Sorry, boy. Tickets are all sold out. Budget cuts, ya know? They're limiting passengers to lighten the load." You raise your brow. Budget cuts?

"This is really important. The Company's done something real bad this time."

"The Company?" Rita's eyes bulge, "Oh dear. Uh... Oh! You see the Conductor over there? Sometimes he allows some extra people onto the train in exchange for something in return. Ya know what I mean?"

"How much?"

"$20 dollahs."

"20!? That's daylight robbery!" She grabs a piece of scrap paper from her cluttered desk and scrawls something on it.

"Here," she says as she hands it to you. "Give it to the kiosk guy. He owes me."

* * *

>give guy money
You can't see any such thing.

>i
You are carrying:
  Paper Scrap
  Velvet Box

>give guy paper
You firmly place the paper scrap onto the kiosk desk. The man looks up from his book, and takes it. He unfolds the paper, and the corner of his mouth tugs upward. He turns to the cash register, and takes out a wad of cash, carefully counting it before he hands it to you. He does not say a word, and returns to his book.

>i
You are carrying:
  Wad of Cash
  Velvet Box

>give conductor cash
You hand the Conductor the wad of cash. He flips through, quickly counting it, and nods.

"Alrighty. You're good to go!" You cringe on the inside. This corruption is not unfamiliar to you, but to engage in it yourself... that's wrong. "ALL ABOARD!" He yells. And steps inside the Train.

>i
You are carrying:
  Wad of Cash
  Velvet Box

>l
Station
The Station is slow and idle. The town is not an attraction, and the Station is merely a stop for business men who need work in the city, or visit home. You see only a few people walking around, luggages in tow. Prominently in the center of the station is a large faded red ticket booth. Next to it is a small kiosk, selling beverages and food items. To the south is the Train, waiting to depart.

* * *

>s
Station
The Station is slow and idle. The town is not an attraction, and the Station is merely a stop for business men who need work in the city, or visit home. You see only a few people walking around, luggages in tow. Prominently in the center of the station is a large faded red ticket booth. Next to it is a small kiosk, selling beverages and food items. To the south is the Train, waiting to depart.

>s
the Sliding Door slid shut just as you leap into the Train Entrance car. You hear the train whir to life. Suddenly, you feel yourself stumble backwards, and find that outside, the scenery begins flying past. You hear the Conductor's voice again: "Hello everybody. We are now headed to the City. Relax, and enjoy your time during this journey."

Train Entrance
A rather small room with little furnishing. There is a small table with a few pamphlets on it. The walls of the Entrance room are mostly glass windows.

You can see Sir Allan and Luna here.

* * *

>e
Town Square
A square plaza with a cobblestone ground. Along the sides of the square are many two-story buildings. At the center of the square is a tall stone fountain, encircled by several wooden benches. Your cottage is to the West. East is the Mayor's House, and South is the Station. There is a crowd gathered outside the Mayor's door.

>e
You pull the on the brass handle, but the door appears to unlocked. Plus, it's not your home-you shouldn't go in without permission.

>talk to mayor
You push and squeeze through the crowd of angry villagers until you come to the Mayor. He does not even notice you until you shake him roughly on the shoulder. You ask "Sir, what is happening?"

"Him," he points to Edgar. "He just informed us that the Company has Felix."

You are taken aback. They have Felix?

"Your son, Felix?"

"Who else?!" The mayor cries angrily. "They want the damn rocks! Now they've resorted to this trickery and blackmailing. What villains!"

"What can we do?" You ask earnestly.

"I don't know," he says as he shakes his head, "Why don't we go into the house to speak."

"Alright." The mayor turns to Edgar and says in his booming voice,

"Enough!" The crowd goes silent. "Edgar. We will give you an answer soon. In the meantime, at least tell me where my son is."

Edgar laughs. "Now? Probably on the way to the Station. I will await your reply," he cackles as he walks away. The mob of villagers glare at Edgar, as he arrogantly strides away. When he is out of sight, the villagers begin to head back to their homes, grumbling to themselves.

You turn to the Mayor and he unlocks the door to his house. You follow him into the spacious mansion.

Mayor's House

>w
You can't go that way.

>w
You can't go that way.

* * *

>s
You can't go that way.

>d
You can't go that way.

>n
You can't go that way.

>sn
That's not a verb I recognise.

>w
You can't go that way.

>sn
That's not a verb I recognise.

>n
You can't go that way.

* * *

>e
Town Square
A square plaza with a cobblestone ground. Along the sides of the square are many two-story buildings. At the center of the square is a tall stone fountain, encircled by several wooden benches. Your cottage is to the West. East is the Mayor's House, and South is the Station. There is a crowd gathered outside the Mayor's door.

>sit on bench
You get onto Benches.

>i
You are carrying nothing.

>l
Town Square (on Benches)
A square plaza with a cobblestone ground. Along the sides of the square are many two-story buildings. At the center of the square is a tall stone fountain, encircled by several wooden benches. East is the Mayor's House. There is a crowd gathered outside the Mayor's door.

* * *

>e
Town Square
A square plaza with a cobblestone ground. Along the sides of the square are many two-story buildings. At the center of the square is a tall stone fountain, encircled by several wooden benches. Your cottage is to the West. East is the Mayor's House, and South is the Station. There is a crowd gathered outside the Mayor's door.

>w
Cottage
A small one room compartment. Shoved into the corner of the room is your bed. Next to the door is your sorry excuse of a kitchen: a small stove, and a sink. At the center of the room is a squat wooden table with the stone on it. On the wall above your sink is a small one way window that looks into Town Square. You can go to Town Square by going East.

>e
Town Square
A square plaza with a cobblestone ground. Along the sides of the square are many two-story buildings. At the center of the square is a tall stone fountain, encircled by several wooden benches. East is the Mayor's House. There is a crowd gathered outside the Mayor's door.

>s
Train Station
The train station is slow and idle. The town is not an attraction, and the train station is merely a stop for business men who need work in the city, or visit home. You see only a few people walking around, luggages in tow. Prominently in the center of the station is a large faded red ticket booth. Next to it is a small kiosk, selling beverages and food items.  Leaning against one of the pillars is a tall lanky boy, who you recognize instantly: Felix. On either side of him are men in black suits, who Felix merrily jokes with. What in the world?

>x ticket booth
A squat boxy room standing in the middle of the station. The ticket booth is old, its bright red color faded from years of neglect. On its faded walls are years of expired promotion posters, graffiti, and dried gum. Its windows are dirty and unclean, but a clean piece of paper is pasted on the glass-a train table. Behind the counter sits a bored woman. On closer inspection, you realize that the woman is a villager named Rita.

>speak to rita
You walk up to the counter, and say,

"Hi Ms. Rita. Long time no see, how have you been?" Her eyes focus, and she smiles grimly.

"Hello Marian,"

"Marcus", you correct.

"Marcus. You know, same old same old. How's ya mother? She good?" You nod.

"Yep. Uh, listen Rita. I need a ticket onto that train over there. How much does it cost?"

"Sorry, boy. Tickets are all sold out. Budget cuts, ya know? They're limiting passengers to lighten the load." You raise your brow. Budget cuts?

"This is really important. The Company's done something real bad this time."

"The Company?" Rita's eyes bulge, "Oh dear. Uh... Oh! You see the Conductor over there? Sometimes he allows some extra people onto the train in exchange for something in return. Ya know what I mean?"

"How much?"

"$75 dollahs."

"75!? That's daylight robbery!" She grabs a piece of scrap paper from her cluttered desk and scrawls something on it.

"Here," she says as she hands it to you. "Give it to the kiosk guy. He owes me."

>i
You are carrying:
  Paper Scrap

>give paper scrap to guy
You firmly place the paper scrap onto the kiosk desk. The man looks up from his book, and takes it. He unfolds the paper, and the corner of his mouth tugs upward. He turns to the cash register, and takes out a wad of cash, carefully counting it before he hands it to you. He does not say a word, and returns to his book.

>undo
Train Station
[Previous turn undone.]

>undo
Train Station
[Previous turn undone.]

>i
You are carrying:
  Paper Scrap

>drop paper scrap
Dropped.

>give paper scrap to guy
(first taking Paper Scrap)
You firmly place the paper scrap onto the kiosk desk. The man looks up from his book, and takes it. He unfolds the paper, and the corner of his mouth tugs upward. He turns to the cash register, and takes out a wad of cash, carefully counting it before he hands it to you. He does not say a word, and returns to his book.

* * *

>s
Train Station
The train station is slow and idle. The town is not an attraction, and the train station is merely a stop for business men who need work in the city, or visit home. You see only a few people walking around, luggages in tow. Prominently in the center of the station is a large faded red ticket booth. Next to it is a small kiosk, selling beverages and food items.  Leaning against one of the pillars is a tall lanky boy, who you recognize instantly: Felix. On either side of him are men in black suits, who Felix merrily jokes with. What in the world?

>give paper scrap to guy
You can't see any such thing.

>take all
There are none at all available!

>take paper scrpa
You can't see any such thing.

>take paper scrap
You can't see any such thing.

>take wad of cash
You can't see any such thing.

* * *

>e
Town Square
A square plaza with a cobblestone ground. Along the sides of the square are many two-story buildings. At the center of the square is a tall stone fountain, encircled by several wooden benches. Your cottage is to the West. East is the Mayor's House, and South is the Station. There is a crowd gathered outside the Mayor's door.

>s
Station
The Station is slow and idle. The town is not an attraction, and the Station is merely a stop for business men who need work in the city, or visit home. You see only a few people walking around, luggages in tow. Prominently in the center of the station is a large faded red ticket booth. Next to it is a small kiosk, selling beverages and food items. To the south is the Train, waiting to depart.  Leaning against one of the pillars is a tall lanky boy, who you recognize instantly: Felix. On either side of him are men in black suits, who Felix merrily jokes with. What in the world?

* * *

>x red ticket booth
A squat boxy room standing in the middle of the station. The ticket booth is old, its bright red color faded from years of neglect. On its faded walls are years of expired promotion posters, graffiti, and dried gum. Its windows are dirty and unclean, but a clean piece of paper is pasted on the glass-a train table. Behind the counter sits a bored woman. On closer inspection, you realize that the woman is a villager named Rita.

>speak to rita
You walk up to the counter, and say,

"Hi Ms. Rita. Long time no see, how have you been?" Her eyes focus, and she smiles grimly.

"Hello Marian,"

"Marcus", you correct.

"Marcus. You know, same old same old. How's ya mother? She good?" You nod.

"Yep. Uh, listen Rita. I need a ticket onto that train over there. How much does it cost?"

"Sorry, boy. Tickets are all sold out. Budget cuts, ya know? They're limiting passengers to lighten the load." You raise your brow. Budget cuts?

"This is really important. The Company's done something real bad this time."

"The Company?" Rita's eyes bulge, "Oh dear. Uh... Oh! You see the Conductor over there? Sometimes he allows some extra people onto the train in exchange for something in return. Ya know what I mean?"

"How much?"

"$20 dollahs."

"20!? That's daylight robbery!" She grabs a piece of scrap paper from her cluttered desk and scrawls something on it.

"Here," she says as she hands it to you. "Give it to the kiosk guy. He owes me."

>give paper to guy
You firmly place the paper scrap onto the kiosk desk. The man looks up from his book, and takes it. He unfolds the paper, and the corner of his mouth tugs upward. He turns to the cash register, and takes out a wad of cash, carefully counting it before he hands it to you. He does not say a word, and returns to his book.

>i
You are carrying:
  Wad of Cash

>give cash to conductor
You hand the Conductor the wad of cash. He flips through, quickly counting it, and nods.

"Alrighty. You're good to go!" You cringe on the inside. This corruption is not unfamiliar to you, but to engage in it yourself... that's wrong. "ALL ABOARD!" He yells. And steps inside the Train.

>undo
Station
[Previous turn undone.]

>s
You walk up to the Train Conductor, an elderly man with a sneer on his face. You say,

"Ah. Hello. I need to get on the train."

"Do you have a ticket?" He asks. You shake your head.

"Do you have anything else that can get you on the train?" He opens his palm towards you, facing upwards.

>give wad of cash to conductor
You hand the Conductor the wad of cash. He flips through, quickly counting it, and nods.

"Alrighty. You're good to go!" You cringe on the inside. This corruption is not unfamiliar to you, but to engage in it yourself... that's wrong. "ALL ABOARD!" He yells. And steps inside the Train.

* * *

>s
Station
The Station is slow and idle. The town is not an attraction, and the Station is merely a stop for business men who need work in the city, or visit home. You see only a few people walking around, luggages in tow. Prominently in the center of the station is a large faded red ticket booth. Next to it is a small kiosk, selling beverages and food items. To the south is the Train, waiting to depart.  Leaning against one of the pillars is a tall lanky boy, who you recognize instantly: Felix. On either side of him are men in black suits, who Felix merrily jokes with. What in the world?

>l
Train Station
The train station is slow and idle. The town is not an attraction, and the train station is merely a stop for business men who need work in the city, or visit home. You see only a few people walking around, luggages in tow. Prominently in the center of the station is a large faded red ticket booth. Next to it is a small kiosk, selling beverages and food items.

* * *

>s
Station
The Station is slow and idle. The town is not an attraction, and the Station is merely a stop for business men who need work in the city, or visit home. You see only a few people walking around, luggages in tow. Prominently in the center of the station is a large faded red ticket booth. Next to it is a small kiosk, selling beverages and food items. To the south is the Train, waiting to depart.  Leaning against one of the pillars is a tall lanky boy, who you recognize instantly: Felix. On either side of him are men in black suits, who Felix merrily jokes with. What in the world?

>give paper scrap to guy
(first taking Paper Scrap)
You firmly place the paper scrap onto the kiosk desk. The man looks up from his book, and takes it. He unfolds the paper, and the corner of his mouth tugs upward. He turns to the cash register, and takes out a wad of cash, carefully counting it before he hands it to you. He does not say a word, and returns to his book.

* * *

>s
Station
The Station is slow and idle. The town is not an attraction, and the Station is merely a stop for business men who need work in the city, or visit home. You see only a few people walking around, luggages in tow. Prominently in the center of the station is a large faded red ticket booth. Next to it is a small kiosk, selling beverages and food items. To the south is the Train, waiting to depart.  Leaning against one of the pillars is a tall lanky boy, who you recognize instantly: Felix. On either side of him are men in black suits, who Felix merrily jokes with. What in the world?

>talk to rita
You walk up to the counter, and say,

"Hi Ms. Rita. Long time no see, how have you been?" Her eyes focus, and she smiles grimly.

"Hello Marian,"

"Marcus", you correct.

"Marcus. You know, same old same old. How's ya mother? She good?" You nod.

"Yep. Uh, listen Rita. I need a ticket onto that train over there. How much does it cost?"

"Sorry, boy. Tickets are all sold out. Budget cuts, ya know? They're limiting passengers to lighten the load." You raise your brow. Budget cuts?

"This is really important. The Company's done something real bad this time."

"The Company?" Rita's eyes bulge, "Oh dear. Uh... Oh! You see the Conductor over there? Sometimes he allows some extra people onto the train in exchange for something in return. Ya know what I mean?"

"How much?"

"$75 dollahs."

"75!? That's daylight robbery!" She grabs a piece of scrap paper from her cluttered desk and scrawls something on it.

"Here," she says as she hands it to you. "Give it to the kiosk guy. He owes me."

>i
You are carrying:
  Paper Scrap

>give paper to guy
You firmly place the paper scrap onto the kiosk desk. The man looks up from his book, and takes it. He unfolds the paper, and the corner of his mouth tugs upward. He turns to the cash register, and takes out a wad of cash, carefully counting it before he hands it to you. He does not say a word, and returns to his book.

* * *

>i
You are carrying:
  Wad of Cash

>s
You walk up to the Train Conductor, an elderly man with a sneer on his face. You say,

"Ah. Hello. I need to get on the train."

"Do you have a ticket?" He asks.

"Do you have anything else that can get you on the train?" He opens his palm towards you, facing upwards.

>give wad of cash to conductor
You hand the Conductor the wad of cash. He flips through, quickly counting it, and nods.

"Alrighty. You're good to go!" You cringe on the inside. This corruption is not unfamiliar to you, but to engage in it yourself... that's wrong. "ALL ABOARD!" He yells. And steps inside the Train.

>s
the door slides shut just as your leap into the car. You hear the train whir to life. Suddenly, the floor lurches beneath you, and you stumble backwards. Outside, the scenery flies past. You hear the Conductor's voice again: "Hello everybody. We are now headed to the City. Relax, and enjoy your time during this journey."

Train

* * *

>x paper
The white scrap of paper is folded. You open it and there's a large six pointed star drawn in the center, with the number 20 written on it. You wonder what kind of favor this guy owes Rita.

* * *

>e
Town Square
A square plaza with a cobblestone ground. Along the sides of the square are many two-story buildings. At the center of the square is a tall stone fountain, encircled by several wooden benches. Your cottage is to the West. East is the Mayor's House, and South is the Station. There is a crowd gathered outside the Mayor's door.

>speak to mayor
You push and squeeze through the crowd of angry villagers until you come to the Mayor. He does not even notice you until you shake him roughly on the shoulder. You ask "Sir, what is happening?"

"Him," he points to Edgar. "He just informed us that the Company has Felix."

You are taken aback. They have Felix?

"Your son, Felix?"

"Who else?!" The mayor cries angrily. "They want the damn rocks! Now they've resorted to this trickery and blackmailing. What villains!"

"What can we do?" You ask earnestly.

"I don't know," he says as he shakes his head, "Why don't we go into the house to speak."

"Alright." The mayor turns to Edgar and says in his booming voice,

"Enough!" The crowd goes silent. "Edgar. We will give you an answer soon. In the meantime, at least tell me where my son is."

Edgar laughs. "Now? Probably on the way to the Station. I will await your reply," he cackles as he walks away. The mob of villagers glare at Edgar, as he arrogantly strides away. When he is out of sight, the villagers begin to head back to their homes, grumbling to themselves.

You turn to the Mayor and he unlocks the door to his house. You follow him into the spacious mansion.

Mayor's House
When you walk into the house, you are stunned by the beautiful furnishing that seems to glitter in the house. At the center of the pearly marble white floor is a large glossy wooden table, on top of which is an elegant flower arrangement. Under a magnificent acrylic painting is a polished stone bench. Sitting on the bench is a worried-looking woman. She is the Mayor's wife, Annabelle.

>x edgar
Edgar is a handsome young man. Although the Company has been around town for more than ten years, Edgar has not aged one bit.

>s
Train Station

>x edgar
You can't see any such thing.

* * *

>g
"Your son, Felix?"

"Who else?!" The mayor cries angrily. "They want the damn rocks! Now they've resorted to this trickery and blackmailing. What villains!"
.

>g
"What can we do?" You ask earnestly.

"I don't know," he says as he shakes his head, "Why don't we go into the house to speak."

"Alright." The mayor turns to Edgar and says in his booming voice,

"Enough!" The crowd goes silent. "Edgar. We will give you an answer soon. In the meantime, at least tell me where my son is."

Edgar laughs. "Now? Probably on the way to the train station. I will await your reply!" He cackles as he walks away.

>g
"Your son, Felix?"

"Who else?!" The mayor cries angrily. "They want the damn rocks! Now they've resorted to this trickery and blackmailing. What villains!"

>g
"Your son, Felix?"

"Who else?!" The mayor cries angrily. "They want the damn rocks! Now they've resorted to this trickery and blackmailing. What villains!"

* * *

>g
"What can we do?" You ask earnestly.

"I don't know," he says as he shakes his head, "Why don't we go into the house to speak."

"Alright." The mayor turns to Edgar and says in his booming voice,

"Enough!" The crowd goes silent. "Edgar. We will give you an answer soon. In the meantime, at least tell me where my son is."

Edgar laughs. "Now? Probably on the way to the train station. I will await your reply!" He cackles as he walks away.

>x edgar
Edgar is a handsome young man. Although the Company has been around town for more than ten years, Edgar has not aged one bit.

* * *

>l
Mayor's House
When you walk into the house, you are stunned by the beautiful furnishing that seems to glitter in the house. At the center of the pearly marble white floor is a large glossy wooden table, on top of which is an elegant flower arrangement. Under a magnificent acrylic painting is a polished stone bench. Sitting on the bench is a worried-looking woman. She is the Mayor's wife, Annabelle.

>speak to annabelle
You approach her, but something about her sunken eyes tell you it wouldn't be considerate.

>talk to annabelle
You approach her, but something about her sunken eyes tell you it wouldn't be considerate.

>l
Mayor's House
When you walk into the house, you are stunned by the beautiful furnishing that seems to glitter in the house. At the center of the pearly marble white floor is a large glossy wooden table, on top of which is an elegant flower arrangement. Under a magnificent acrylic painting is a polished stone bench. Sitting on the bench is a worried-looking woman. She is the Mayor's wife, Annabelle.

>speak to mayor
"Mayor, I think we need to hurry." The Mayor closes his eyes and sinks to the floor.

"Yes," he murmurs, "We should. Sheriff, I need you to chase my son. I am well past my prime, and cannot leave the villagers. Our Lady only knows what they would do if I walked away from the town. Please go to the Station and save my son." You nod dutifully, and walk to the exit.

"Please take this," Annabelle says in a pale whisper, as she hands you a small velvet box.

Town Square
A square plaza with a cobblestone ground. Along the sides of the square are many two-story buildings. At the center of the square is a tall stone fountain, encircled by several wooden benches. Your cottage is to the West. East is the Mayor's House, and South is the Station. There is a crowd gathered outside the Mayor's door.

>e
You pull the on the brass handle, but the door appears to unlocked. Plus, it's not your home-you shouldn't go in without permission.

>s
Station
The Station is slow and idle. The town is not an attraction, and the Station is merely a stop for business men who need work in the city, or visit home. You see only a few people walking around, luggages in tow. Prominently in the center of the station is a large faded red ticket booth. Next to it is a small kiosk, selling beverages and food items. To the south is the Train, waiting to depart.  Leaning against one of the pillars is a tall lanky boy, who you recognize instantly: Felix. On either side of him are men in black suits, who Felix merrily jokes with. What in the world?

* * *

>talk to mayor
You push and squeeze through the crowd of angry villagers until you come to the Mayor. He does not even notice you until you shake him roughly on the shoulder. You ask "Sir, what is happening?"

"Him. He just informed us that the Company has Felix."

* * *

>s
You can't go that way.

>e
Town Square
A square plaza with a cobblestone ground. Along the sides of the square are many two-story buildings. At the center of the square is a tall stone fountain, encircled by several wooden benches. Your cottage is to the West. East is the Mayor's House, and South is the Station. There is a crowd gathered outside the Mayor's door.

>s
You have no reason to go to the Station.

* * *

I beg your pardon?

>talk to mayor
"Mayor, I think we need to hurry." The Mayor closes his eyes and sinks to the floor.

"Yes," he murmurs, "We should. Sheriff, I need you to chase my son. I am well past my prime, and cannot leave the villagers. Our Lady only knows what they would do if I walked away from the town. Please go to the Station and save my son." You nod dutifully, and walk to the exit.

"Please take this," Annabelle says in a pale whisper, as she hands you a small velvet box.

Town Square
A square plaza with a cobblestone ground. Along the sides of the square are many two-story buildings. At the center of the square is a tall stone fountain, encircled by several wooden benches. Your cottage is to the West. East is the Mayor's House, and South is the Station. There is a crowd gathered outside the Mayor's door.

* * *

>give guy scrap
You firmly place the paper scrap onto the kiosk desk. The man looks up from his book, and takes it. He unfolds the paper, and the corner of his mouth tugs upward. He turns to the cash register, and takes out a wad of cash, carefully counting it before he hands it to you. He does not say a word, and returns to his book.

>give conductor money
You can't see any such thing.

>give conductor cash
You hand the Conductor the wad of cash. He flips through, quickly counting it, and nods.

"Alrighty. You're good to go!" You cringe on the inside. This corruption is not unfamiliar to you, but to engage in it yourself... that's wrong. "ALL ABOARD!" He yells. And steps inside the Train.

>n
Town Square
A square plaza with a cobblestone ground. Along the sides of the square are many two-story buildings. At the center of the square is a tall stone fountain, encircled by several wooden benches. Your cottage is to the West. East is the Mayor's House, and South is the Station. There is a crowd gathered outside the Mayor's door.

* * *

>s
the Sliding Door slid shut just as you leap into the Train Entrance car. You hear the train whir to life. Suddenly, you feel yourself stumble backwards, and find that outside, the scenery begins flying past. You hear the Conductor's voice again: "Hello everybody. We are now headed to the City. Relax, and enjoy your time during this journey."

Train Entrance
A rather small room with little furnishing. There is a small table with a few pamphlets on it. The walls of the Entrance room are mostly glass windows.

You can see Luna and Sir Allan here.

>talk to sir allan
You can ask Sir Allan about:

Himself.

The purpose of his journey.

What he was doing and where during the time of the crime.

The victim.

>i
You are carrying:
  Wad of Cash
  Velvet Box

>talk to luna
You can ask Audrey about:

Herself.

The purpose of her journey.

The victim.

anything suspicious.

>ask luna if she saw anything suspicious
I didn't understand that sentence.

>ask lune about anything suspicious
You can't see any such thing.

>ask luna about anything suspicious
she saw mark looking through victim's belongings.

>i
You are carrying:
  MarkInformation 1
  Wad of Cash
  Velvet Box

>e
Passenger Car
The room is longer than it is wide. There are about 30 open seats, but only a few are occupied. Along the walls are large glass windows. To the East is the Dining Car.

You can see Mark and Audrey here.

>talk to mark
You can ask Mark about:

Himself.

The purpose of his journey.

What he was doing and where during the time of the crime.

The victim.

>talk to mark
You can ask Mark about:

Himself.

The purpose of his journey.

What he was doing and where during the time of the crime.

The victim.

>i
You are carrying:
  MarkInformation 1
  Wad of Cash
  Velvet Box

>ask mark about him looking through victim's belongings
he says he did no such thing.

>i
You are carrying:
  MarkInformation 2
  Wad of Cash
  Velvet Box

>talk to mark
You can ask Mark about:

Himself.

The purpose of his journey.

What he was doing and where during the time of the crime.

The victim.

>i
You are carrying:
  MarkInformation 2
  Wad of Cash
  Velvet Box

>ask audrey about her husband stealing
she knows nothing about it, and says that her husband is a good family man.

>i
You are carrying:
  AudreyInformation 2
  MarkInformation 2
  Wad of Cash
  Velvet Box

>ask audrey about $200 dollars in mark's possession
her eyes widen at the mention of $200 dollars. she realizes that mark must have stolen it because it is the exact sum that they needed in order to pay for their child's medicine.