You wake up to shouts and loud banging. It is early; the sun has just begun to rise. After groggily getting out from bed, you peer out the window. There is a crowd of people gathered outside in front of the Mayor's House.  It's too early! What is happening?

Mercenaries
An Interactive Fiction by Elana Shi
Release 1 / Serial number 141019 / Inform 7 build 6L38 (I6/v6.33 lib 6/12N) SD

Cottage
A small one room compartment. Shoved into the corner of the room is your bed. Next to the door is your sorry excuse of a kitchen: a small stove, and a sink. At the center of the room is a squat wooden table with the stone on it. On the wall above your sink is a small one way window that looks into Town Square. You can go to Town Square by going East.

I beg your pardon?

* * *

>w
You can't go that way.

>e
Town Square

* * *

>x stone
The townspeople call it Lady's Flower. The opaque material is an intense purple, mixed with grays and whites. The colors swirls into intricate patterns that almost look artificially enhanced. Just two years ago, there were only a couple of stones that a select few families held. But then the Company discovered the precious materials, and began digging deep into the villager's farms. There, they found masses of the Lady's Flower, which they called Charoite. Shortly after, they offered a huge sum of money to the town's mayor, hoping that he would allow the Company to keep digging. The mayor refused.

>x window
The window overlooks Town Hall.

* * *

>x window
The window overlooks Town Hall. There is a crowd of people gathered outside.

>e
Town Square
A square plaza with a cobblestone ground. Along the sides of the square are many two-story buildings. At the center of the square is a tall stone fountain, encircled by several wooden benches. East is the Mayor's House. There is a crowd gathered outside the Mayor's door.

>x crowd
The crowd consists of angry village women and men. They hold pitchforks and shovel; you cannot see what's happening.

* * *

>l
Cottage
A small one room compartment. Shoved into the corner of the room is your bed. Next to the door is your sorry excuse of a kitchen: a small stove, and a sink. At the center of the room is a squat wooden table. On the wall above your sink is a small one way window that looks into Town Square.

>x sink
Yesterday, the mayor cut off all water from the pipes to prevent the Company's factory from working. Although it was inconvenient, the town's residents all agreed that we needed to send a warning to the Company.

>x stove
Occasionally you dabble in some cooking, and you're quite good at it too. The neighbors often ask for recipes and tips, which you willingly give. The stove itself is quite old, as you bought it from a second hand store.

* * *

>e
Town Square
A square plaza with a cobblestone ground. Along the sides of the square are many two-story buildings. At the center of the square is a tall stone fountain, encircled by several wooden benches. East is the Mayor's House. There is a crowd gathered outside the Mayor's door.

>stand on bench
You get onto Benches.

After stepping onto the bench, you take a look over the crowd. What you see does not surprise you. A young man in a black suit stands proudly at the center of the crowd, a smirk corrupting his handsome face. This man is Edgar, a representative of the Company.

>x crowd
The crowd consists of angry village women and men. They hold pitchforks and shovel; you cannot see what's happening.

>x crowd
The crowd consists of angry village women and men. They hold pitchforks and shovel; you cannot see what's happening.

* * *

>stand on bench
You get onto Benches.

After stepping onto the bench, you take a look over the crowd. What you see does not surprise you. A young man in a black suit stands proudly at the center of the crowd, a smirk corrupting his handsome face. This man is Edgar, a representative of the Company.

>get off bench
You get off Benches.

Town Square
A square plaza with a cobblestone ground. Along the sides of the square are many two-story buildings. At the center of the square is a tall stone fountain, encircled by several wooden benches. East is the Mayor's House. There is a crowd gathered outside the Mayor's door.

>x crowd
The crowd consists of angry village women and men. They hold pitchforks and shovel; you cannot see what's happening.

>stand on bench
You get onto Benches.

After stepping onto the bench, you take a look over the crowd. What you see does not surprise you. A young man in a black suit stands proudly at the center of the crowd, a smirk corrupting his handsome face. This man is Edgar, a representative of the Company.

>x edgar
You see nothing special about Edgar.

* * *

>e
Town Square
A square plaza with a cobblestone ground. Along the sides of the square are many two-story buildings. At the center of the square is a tall stone fountain, encircled by several wooden benches. East is the Mayor's House. There is a crowd gathered outside the Mayor's door.

>x edgar
Edgar is a handsome young man. Although the Company has been around town for more than ten years, Edgar has not aged one bit.

* * *

>e
Town Square
A square plaza with a cobblestone ground. Along the sides of the square are many two-story buildings. At the center of the square is a tall stone fountain, encircled by several wooden benches. East is the Mayor's House. There is a crowd gathered outside the Mayor's door.

>sit on bench
You get onto Benches.

* * *

>e
Town Square
A square plaza with a cobblestone ground. Along the sides of the square are many two-story buildings. At the center of the square is a tall stone fountain, encircled by several wooden benches. East is the Mayor's House. There is a crowd gathered outside the Mayor's door.

>speak to mayor
You push and squeeze through the crowd of angry villagers until you come to the Mayor. He does not even notice you until you shake him roughly on the shoulder. You ask "Sir, what is happening?"

"Him," he points to Edgar. "He just informed us that the Company has Felix."

You are taken aback. They have Felix?

"Your son, Felix?"

"Who else?!" The mayor cries angrily. "They want the damn rocks! Now they've resorted to this trickery and blackmailing. What villains!"

"What can we do?" You ask earnestly.

"I don't know," he says as he shakes his head, "Why don't we go into the house to speak."

"Alright." The mayor turns to Edgar and says in his booming voice,

"Enough!" The crowd goes silent. "Edgar. We will give you an answer soon. In the meantime, at least tell me where my son is."

Edgar laughs. "Now? Probably on the way to the train station. I will await your reply!" He cackles as he walks away.

>talk to mayor
You push and squeeze through the crowd of angry villagers until you come to the Mayor. He does not even notice you until you shake him roughly on the shoulder. You ask "Sir, what is happening?"

"Him. He just informed us that the Company has Felix."

* * *

>g
"Your son, Felix?"

"Who else?!" The mayor cries angrily. "They want the damn rocks! Now they've resorted to this trickery and blackmailing. What villains!"
.

* * *

>x edgar
Edgar is a handsome young man. Although the Company has been around town for more than ten years, Edgar has not aged one bit.

* * *

>s
You can't go that way.

* * *

>w
You can't go that way.

>e
Town Square
A square plaza with a cobblestone ground. Along the sides of the square are many two-story buildings. At the center of the square is a tall stone fountain, encircled by several wooden benches. East is the Mayor's House. There is a crowd gathered outside the Mayor's door.

Edgar is a handsome young man. Although the Company has been around town for more than ten years, Edgar has not aged one bit.

>sit on bench
You can't see any such thing.

* * *

>d
You can't go that way.

>w
You can't go that way.

>e
Town Square
A square plaza with a cobblestone ground. Along the sides of the square are many two-story buildings. At the center of the square is a tall stone fountain, encircled by several wooden benches. East is the Mayor's House. There is a crowd gathered outside the Mayor's door.

>sit on bench
You get into Benches.