Welcome
An Interactive Fiction
Release 1 / Serial number 141023 / Inform 7 build 6L38 (I6/v6.33 lib 6/12N) SD

Train Entrance
A rather small room with little furnishing. There is a small table with a few pamphlets on it. The walls of the Entrance room are mostly glass windows.

I beg your pardon?

>Every turn rule:
That's not a verb I recognise.

>Instead of talking to Mark, say "[if player is carrying MarkInformation 1] You can ask Mark about:
You seem to want to talk to someone, but I can't see whom.

I beg your pardon?

>Himself.
That's not a verb I recognise.

I beg your pardon?

>The purpose of his journey.
That's not a verb I recognise.

I beg your pardon?

>What he was doing and where during the time of the crime.
That's not a verb I recognise.

I beg your pardon?

>The victim.
That's not a verb I recognise.

I beg your pardon?

* * *

Welcome
An Interactive Fiction
Release 1 / Serial number 141023 / Inform 7 build 6L38 (I6/v6.33 lib 6/12N) SD

Train Entrance
A rather small room with little furnishing. There is a small table with a few pamphlets on it. The walls of the Entrance room are mostly glass windows.

>talk to mark
You can ask Mark about:

Himself.

The purpose of his journey.

What he was doing and where during the time of the crime.

The victim.

>ask about victim
You can't see any such thing.

>ask mark about victim
There is no reply.

>ask mark about the victim
he saw the victim arguing with sir allan, and flirting with luna.

>i
You are carrying:
  SirAllan1

>x sir allan1
I only understood you as far as wanting to examine Sir Allan.

>i
You are carrying:
  SirAllan1

>sirallan1
That's not a verb I recognise.

>x sirallan1
Sir Allan was arguing with the victim.

* * *

Welcome
An Interactive Fiction
Release 1 / Serial number 141023 / Inform 7 build 6L38 (I6/v6.33 lib 6/12N) SD

Train Entrance
A rather small room with little furnishing. There is a small table with a few pamphlets on it. The walls of the Entrance room are mostly glass windows.

>speak to mark
You can ask Mark about:

How he is doing today.

The purpose of his journey.

What he was doing and where during the time of the crime.

The victim.

>ask mark about how he is doing today
There is no reply.

* * *

Welcome
An Interactive Fiction
Release 1 / Serial number 141023 / Inform 7 build 6L38 (I6/v6.33 lib 6/12N) SD

Train Entrance
A rather small room with little furnishing. There is a small table with a few pamphlets on it. The walls of the Entrance room are mostly glass windows.

>take all
There are none at all available!

>i
You are carrying:
  AudreyInformation 3

* * *

>take all
There are none at all available!

>speak to mark
You can ask Mark about:

Himself.

The purpose of his journey.

What he was doing and where during the time of the crime.

The victim.

>ask mark about victim
There is no reply.

* * *

>ask mark about the victim
he saw the victim arguing with sir allan, and flirting with luna.

>talk to sir allan
You can ask Sir Allan about:

Himself.

The purpose of his journey.

What he was doing and where during the time of the crime.

The victim.

>ask sir allan about the victim
he was friendly, and a nice boy who helped sir allan put his luggage onto the luggage rack.

>ask sir allan about his argument with the victim
sir allan is taken aback, but regains his composure quickly. he says that he suspected that felix stole a $50 dollar bill from his luggage, and felix said he didn't.

>speak to luna
You can ask Audrey about:

Herself.

The purpose of her journey.

The victim.

>ask luna about anything suspicious
she saw mark looking through victim's belongings.

>i
You are carrying:
  MarkInformation 1
  SirAllanInformation 2
  SirAllanInformation 1

>x markinformation 1
Mark was seen rummaging through the victim's belongings.

>ask mark about looking through victim's belongings
he says he did no such thing.

>ask audrey about her husband stealing
she knows nothing about it, and says that her husband is a good family man.

>i
You are carrying:
  AudreyInformation 2
  MarkInformation 2
  SirAllanInformation 2
  SirAllanInformation 1

>x sirallaninformation 1
You see nothing special about SirAllanInformation 1.

>x sirallaninformation 2
You see nothing special about SirAllanInformation 2.

* * *

Welcome
An Interactive Fiction
Release 1 / Serial number 141023 / Inform 7 build 6L38 (I6/v6.33 lib 6/12N) SD

Train Entrance
A rather small room with little furnishing. There is a small table with a few pamphlets on it. The walls of the Entrance room are mostly glass windows.

>tie silk belt to metal rod
You can't see any such thing.

>climb ladder
You grip the cold metal handle and pull yourself up.

Roof
At the top of the train, you feel very unsafe. However, as you gaze at your surroundings, you are struck with admiration of the beautiful landscape. In front of you, there is a long stretch of white panels that is the roof. You notice that there is a metal rod running across the edges of each car.

You can see Silk Belt here.

>climb belt to rod
I only understood you as far as wanting to climb Silk Belt.

>tie silk belt to metal rod
You tie the silk belt securely on the metal rod. When you pull, you are surprised by the strength the belt.

Bathroom

* * *

Welcome
An Interactive Fiction
Release 1 / Serial number 141023 / Inform 7 build 6L38 (I6/v6.33 lib 6/12N) SD

Train Entrance
A rather small room with little furnishing. There is a small table with a few pamphlets on it. The walls of the Entrance room are mostly glass windows.

>ask mark about himself
fine.

* * *

Welcome
An Interactive Fiction
Release 1 / Serial number 141023 / Inform 7 build 6L38 (I6/v6.33 lib 6/12N) SD

Train Entrance
A rather small room with little furnishing. There is a small table with a few pamphlets on it. The walls of the Entrance room are mostly glass windows.

>i
You are carrying nothing.

>speak to mark
You can ask Mark about:

Himself.

The purpose of his journey.

What he was doing and where during the time of the crime.

The victim.

>ask mark about himself
worried. will the mystery keep the people on the train after they arrive?

>i
You are carrying nothing.

>ask mark about the purpose of his journey
going to city for son's medicine.

>ask mark about What he was doing and where during the time of the crime
taking a nap in his private room.

>ask mark about the victim
he saw the victim arguing with sir allan, and flirting with luna.

>speak to sir allan
You can ask Sir Allan about:

Himself.

The purpose of his journey.

What he was doing and where during the time of the crime.

The victim.

I beg your pardon?

>ask sir allan about himself
a little shaken, but fine.

>ask sir allan about The purpose of his journey
returning to the city after his retirement vacation.

>ask sir allan about What he was doing and where during the time of the crime
speaking to you.

>ask sir allan about The victim
he was friendly, and a nice boy who helped sir allan put his luggage onto the luggage rack.

>talk to audrey
You can ask Audrey about:

Herself.

The purpose of her journey.

What she was doing and where when the crime happened.

The victim.

>ask audrey about herself
she is very scared. she hopes the victim killed himself rather than someone killing him.

>ask audrey about The purpose of her journey
going to city for son's medicine.

>ask audrey about What she was doing and where when the crime happened.
There is no reply.

>ask audrey about the victim
she did not meet the victim. she only saw him and thought that he was very handsome. if anything, she saw sir allan and the victim arguing outside at the veranda.

>ask sir allan about his argument with the victim
sir allan is taken aback, but regains his composure quickly. he says that he suspected that felix stole a $50 dollar bill from his luggage, and felix said he didn't.

* * *

Welcome
An Interactive Fiction
Release 1 / Serial number 141023 / Inform 7 build 6L38 (I6/v6.33 lib 6/12N) SD

Train Entrance
A rather small room with little furnishing. There is a small table with a few pamphlets on it. The walls of the Entrance room are mostly glass windows.

>e
Passenger Car
The room is longer than it is wide. There are about 30 open seats, but only a few are occupied. Along the walls are large glass windows. To the East is the Observation Car.

>w
You can't go that way.

>s
You can't go that way.

>n
You can't go that way.

>climb up ladder
You grip the cold metal handle and pull yourself up.

Roof

>s
You can't go that way.

>w
You can't go that way.

I beg your pardon?

>e
You can't go that way.

>n
You can't go that way.

* * *

>e
Passenger Car
The room is longer than it is wide. There are about 30 open seats, but only a few are occupied. Along the walls are large glass windows. To the East is the Observation Car.

>e
Observation Car
A long with glass window on the walls and ceiling. There are several couches facing the windows, so that people can watch the beautiful scenery fly by.

>climb ladder
You grip the cold metal handle and pull yourself up.

Roof
At the top of the train, you feel very unsafe. However, as you gaze at your surroundings, you are struck with admiration of the beautiful landscape. In front of you, there is a long stretch of white panels that is the roof. You notice that there is a metal rod running across the edges of each car.

>climb ladder
You grip the cold metal handle and step down.

Observation Car
A long with glass window on the walls and ceiling. There are several couches facing the windows, so that people can watch the beautiful scenery fly by.

>e
You can't go that way.

>w
Passenger Car
The room is longer than it is wide. There are about 30 open seats, but only a few are occupied. Along the walls are large glass windows. To the East is the Observation Car.

>e
Observation Car
A long with glass window on the walls and ceiling. There are several couches facing the windows, so that people can watch the beautiful scenery fly by.

>c
That's not a verb I recognise.

>s
You can't go that way.

* * *

>n
You can't go that way.

>e
You can't go that way.

>s
You can't go that way.

>w
Passenger Car
The room is longer than it is wide. There are about 30 open seats, but only a few are occupied. Along the walls are large glass windows. To the East is the Observation Car.

>n
You can't go that way.

>e
Observation Car
A long with glass window on the walls and ceiling. There are several couches facing the windows, so that people can watch the beautiful scenery fly by.

>en
That's not a verb I recognise.

>e
You can't go that way.

* * *

>n
You can't go that way.

>s
You can't go that way.

* * *

Welcome
An Interactive Fiction
Release 1 / Serial number 141023 / Inform 7 build 6L38 (I6/v6.33 lib 6/12N) SD

Train Entrance
A rather small room with little furnishing. There is a small table with a few pamphlets on it. The walls of the Entrance room are mostly glass windows.

>n
Roof

>e
Observation Car

>n
Roof

>w
You can't go that way.

>n
You can't go that way.

>w
You can't go that way.

>e
Observation Car

>s
You can't go that way.

>n
Roof

>s
You can't go that way.

* * *

>n
You can't go that way.

>n
You can't go that way.

* * *

>s
You can't go that way.

>s
You can't go that way.

* * *

Welcome
An Interactive Fiction
Release 1 / Serial number 141023 / Inform 7 build 6L38 (I6/v6.33 lib 6/12N) SD

Train Entrance
A rather small room with little furnishing. There is a small table with a few pamphlets on it. The walls of the Entrance room are mostly glass windows.

>climb up ladder
You grip the cold metal handle and pull yourself up.

Roof
At the top of the train, you feel very unsafe. However, as you gaze at your surroundings, you are struck with admiration of the beautiful landscape. In front of you, there is a long stretch of white panels that is the roof. You notice that there is a metal rod running across the edges of each car.

You can see Silk Belt here.

>tie silk belt to waist
You wrap a portion of the belt around your waist, but realize that it's not attached to anything, and take off the belt.
 
Bathroom

>tie silk belt to metal rod
You can't see any such thing.

>tie silk belt to wait
You can't see any such thing.

>tie belt to waist
You can't see any such thing.

* * *

>climb up ladder
You grip the cold metal handle and pull yourself up.

Roof
At the top of the train, you feel very unsafe. However, as you gaze at your surroundings, you are struck with admiration of the beautiful landscape. In front of you, there is a long stretch of white panels that is the roof. You notice that there is a metal rod running across the edges of each car.

You can see Silk Belt here.

>tie silk belt to rod
You tie the silk belt securely on the metal rod. When you pull, you are surprised by the strength the belt.

Bathroom

>tie belt to metal rod
You can't see any such thing.

>tie silk belt to metal rod
You can't see any such thing.

>i
You are carrying nothing.

I beg your pardon?

>n
You can't go that way.

* * *

Welcome
An Interactive Fiction
Release 1 / Serial number 141023 / Inform 7 build 6L38 (I6/v6.33 lib 6/12N) SD

Train Entrance
A rather small room with little furnishing. There is a small table with a few pamphlets on it. The walls of the Entrance room are mostly glass windows.

>climb ladder
You grip the cold metal handle and pull yourself up.

Roof
At the top of the train, you feel very unsafe. However, as you gaze at your surroundings, you are struck with admiration of the beautiful landscape. In front of you, there is a long stretch of white panels that is the roof. You notice that there is a metal rod running across the edges of each car.

You can see Silk Belt here.

>tie silk belt to waist
You wrap a portion of the belt around your waist, but realize that it's not attached to anything, and take off the belt.

>i
You are carrying nothing.

>tie silk belt to metal rod
You tie the silk belt securely on the metal rod. When you pull, you are surprised by the strength the belt.

>climb down ladder
You grip the cold metal handle and step down.

Observation Car

>climb up ladder
You grip the cold metal handle and pull yourself up.

Roof
At the top of the train, you feel very unsafe. However, as you gaze at your surroundings, you are struck with admiration of the beautiful landscape. In front of you, there is a long stretch of white panels that is the roof. You notice that there is a metal rod running across the edges of each car.

>tie silk belt to metal rod
You tie the silk belt securely on the metal rod. When you pull, you are surprised by the strength the belt.

>tie silk belt to waist
 You wrap a portion of the belt around your waist. When you are done, you carefully lower yourself on the side of the train, gripping the metal rod for support. Suddenly, your foot hits a window sill. You continue to lower yourself into the window, until you are completely in the bathroom.